정류소명,정류소아이디,총승차건수,총하차건수,승차건수(카드),하차건수(카드),승차건수(현금),일평균승하차건수
(구)국제여객터미널,35051,6,1070,2,1070,4,34
(구)국제여객터미널,35052,1470,23,1465,23,5,48
(주)경동세라믹스,89146,588,22,583,22,5,19
(주)경인양행앞,42096,1137,952,1137,952,0,67
(주)경인양행앞,42097,1870,4050,1870,4050,0,190
(주)대한특수금속,39050,1306,72,1306,72,0,44
(주)두남,39135,288,67,288,67,0,11
(주)세모입구(린나이코리아),37585,1182,2086,1182,2086,0,105
(주)세모입구(린나이코리아),40893,346,829,346,829,0,37
(주)스킨이데아,89388,302,426,302,426,0,23
(주)스킨이데아,89389,2396,12,2396,12,0,77
(주)씨피엔텍,39133,494,3523,494,3523,0,129
(주)씨피엔텍,39134,2227,454,2227,454,0,86
(주)창원,39029,3492,3011,3492,3011,0,209
(주)창원,39030,4333,3761,4333,3761,0,261
(주)하나금속,39124,20,57,20,57,0,2
17사단.다임메가타운,40895,2002,4579,1996,4579,6,212
17사단입구,40832,9,457,4,457,5,15
1차풍림아이원,42642,4988,9,4988,9,0,161
2001아울렛,40154,3147,5278,3147,5278,0,271
2001아울렛,40159,29219,11849,29180,11849,39,1324
2001아울렛,40162,9787,20209,9770,20209,17,967
2001아울렛부평점,40158,4409,2296,4372,2296,37,216
2차풍림아이원,42584,22,10583,22,10583,0,342
3단지,40736,102,1605,102,1605,0,55
3단지관리사무소,40107,1685,275,1685,275,0,63
41번구종점,42174,2011,5884,2011,5884,0,254
510번차고지,36145,948,343,948,343,0,41
540번종점,39470,3028,40,2990,40,38,98
6공단사거리,37577,299,2391,298,2391,1,86
6공단입구,37442,616,877,616,877,0,48
6공단입구,37443,1012,1530,1012,1530,0,82
8부두,35181,151,1919,147,1919,4,66
8부두,35182,1423,2137,1408,2137,15,114
CJ인천2공장,35591,335,3342,330,3342,5,118
CJ인천2공장,35592,2552,79,2550,79,2,84
E편한세상,42453,2261,918,2259,918,2,102
E편한세상,42649,1359,2763,1359,2763,0,132
E편한세상,42726,2923,1360,2918,1360,5,138
GM물류센터,40568,505,1251,505,1251,0,56
GS25편의점,36142,1050,2526,1036,2526,14,115
GS내리주유소,44130,0,4,0,4,0,0
GS내리주유소,44147,2,0,2,0,0,0
GS칼텍스,35168,599,40,597,40,2,20
GS칼텍스,35557,2,2039,1,2039,1,65
GS칼텍스,89220,165,624,165,624,0,25
GS칼텍스,89224,104,1199,104,1199,0,42
GS칼텍스주유소,39814,218,10,218,10,0,7
HD현대인프라코어,36081,692,1573,691,1573,1,73
HD현대인프라코어,36083,2233,1026,2223,1026,10,105
HD현대인프라코어후문,36077,11,865,7,865,4,28
HD현대인프라코어후문,36078,3918,816,3912,816,6,152
JC회관,37383,3831,4227,3829,4227,2,259
JST기술연구소,89491,2,1737,2,1737,0,56
JST기술연구소,89492,594,26,582,26,12,20
KCC아파트,42391,2004,1444,2002,1444,2,111
KG스틸,42008,2212,4221,2204,4221,8,207
KTX광명역4번출구,58057,3041,16,3041,16,0,98
KT부평지사,40381,9301,6063,9243,6063,58,495
KT부평지사,40384,6423,12066,6395,12066,28,596
KT서인천지사,42932,1487,2652,1487,2652,0,133
KT서인천지사,42933,1843,990,1842,990,1,91
KT송도지점,38568,653,412,653,412,0,34
KT온수분국,43523,505,245,503,245,2,24
KT인천공항지사,35095,244,59,244,59,0,9
KT인천공항지사,35109,6904,3510,6898,3510,6,335
KT인천지사,37415,5995,4270,5975,4270,20,331
KT인천지사,39319,7681,4648,7647,4648,34,397
KT중동지사,55081,766,220,765,220,1,31
KT중동지사,55082,184,1118,184,1118,0,42
LG마그나,89029,6723,3053,6718,3053,5,315
LG마그나,89264,3237,5590,3237,5590,0,284
LG물류센터,39043,433,203,433,203,0,20
LG물류센터,39044,84,616,84,616,0,22
LG전자(주),42297,5187,4289,5185,4289,2,305
LH1단지,35494,9384,3718,9382,3718,2,422
LH1단지,35495,3426,6507,3424,6507,2,320
LH49단지행복주택아파트,35768,786,1317,786,1317,0,67
LH49단지행복주택아파트,35769,1836,743,1835,743,1,83
LH7단지,35451,3303,1686,3300,1686,3,160
LH7단지,35452,2111,3426,2111,3426,0,178
LH미추홀3단지,37222,3043,6511,3000,6511,43,308
LH미추홀3단지,37635,6420,2872,6404,2872,16,299
LH웨스턴블루힐정문,89184,1553,3205,1553,3205,0,153
LH웨스턴블루힐정문,89185,3819,3557,3815,3557,4,237
NKG물류센터,89212,207,58,207,58,0,8
SK.GS주유소,89230,1412,1650,1412,1650,0,98
SK.GS주유소,89231,1767,2066,1767,2066,0,123
SKLPG충전사업소,35636,941,32,937,32,4,31
SKLPG충전사업소,35638,28,907,2,907,26,30
SK뷰아파트,42888,1366,5084,1366,5084,0,208
SK뷰아파트,42889,6405,1183,6405,1183,0,244
SK스카이뷰,37601,346,29423,346,29423,0,960
SK스카이뷰104동,37587,6401,33,6401,33,0,207
SK스카이뷰109동,37607,7247,50,7247,50,0,235
SK인천석유화학,42767,1238,757,1238,757,0,64
SK인천석유화학,42768,496,680,495,680,1,37
SK주유소,42956,232,298,231,298,1,17
SK주유소앞,35287,1498,111,1494,111,4,51
SK주유소앞,35539,59,1423,57,1423,2,47
SK충전소,35085,23,2215,16,2215,7,72
e편한세상 정문,38624,22009,1348,22000,1348,9,753
e편한세상(109동 앞),32062,786,1176,786,1176,0,63
e편한세상(109동앞),38643,960,586,960,586,0,49
e편한세상1차(정문),35662,466,984,466,984,0,46
e편한세상1차(정문),35663,1428,454,1428,454,0,60
e편한세상계양,41037,13967,3426,13958,3426,9,561
e편한세상계양,41038,4801,14056,4801,14056,0,608
e편한세상영종센텀베뉴정문,35510,1180,4244,1180,4244,0,174
e편한세상영종오션하임,35674,1620,526,1620,526,0,69
e편한세상영종오션하임,35761,629,1337,629,1337,0,63
e편한세상영종하늘도시,35646,565,648,565,648,0,39
e편한세상영종하늘도시,35647,288,367,288,367,0,21
gym80fitness,37081,2637,879,2621,879,16,113
가경공원,89365,1087,531,1087,531,0,52
가구단지사거리,37455,2846,3723,2834,3723,12,211
가구단지사거리,37456,3127,2159,3122,2159,5,170
가구전시장,42072,483,529,478,529,5,32
가구전시장,42074,745,540,740,540,5,41
가나안마을앞,43904,3,25,3,25,0,0
가나안마을앞,43905,28,0,28,0,0,0
가능포,43969,6,1,6,1,0,0
가능포,43970,6,10,6,10,0,0
가림고등학교,42078,11034,12440,10964,12440,70,757
가야,42807,1235,5,1235,5,0,40
가야,42808,9,1391,9,1391,0,45
가오대입구,80033,112,414,108,414,4,16
가오대입구,80034,98,565,98,565,0,21
가원초등학교,42952,5555,4327,5548,4327,7,318
가원초등학교,89118,2447,4865,2442,4865,5,235
가재우물터,35678,19,10,19,10,0,0
가재우물터,35700,1,11,1,11,0,0
가재울사거리,42039,2333,5379,2327,5379,6,248
가재울사거리,42042,8540,4768,8529,4768,11,429
가재울역,42034,2639,3197,2633,3197,6,188
가재울역,42035,3206,2157,3190,2157,16,173
가정(루원시티)역,89050,6551,52006,6551,52006,0,1888
가정(루원시티)역,89051,67130,8670,67130,8670,0,2445
가정(루원시티)역,89075,72618,76871,72588,76871,30,4822
가정(루원시티)역,89078,79002,68210,78956,68210,46,4748
가정3동성당,42226,427,2953,425,2953,2,109
가정LH3단지정문앞,89041,18240,3945,18208,3945,32,715
가정고등학교,42200,9782,3988,9722,3988,60,444
가정고등학교,42203,2684,6580,2654,6580,30,298
가정교,89502,176,1455,175,1455,1,52
가정교,89503,1989,279,1986,279,3,73
가정교차로,89390,518,936,518,936,0,46
가정교차로,89391,335,2409,334,2409,1,88
가정동성당,89102,3013,3765,3009,3765,4,218
가정동성당,89105,2449,1604,2448,1604,1,130
가정보금자리,89119,1492,708,1492,708,0,70
가정보금자리,89120,121,1426,121,1426,0,49
가정여자중학교,42041,754,7749,736,7749,18,274
가정여중입구,89303,927,780,908,780,19,55
가정중앙시장역,42215,1058,1455,1057,1455,1,81
가정중앙시장역,42219,1101,1404,1088,1404,13,80
가정택지삼거리,89385,280,141,280,141,0,13
가정택지삼거리,89386,131,563,131,563,0,22
가정휴먼시아3단지,89186,1259,1494,1259,1494,0,88
가정휴먼시아3단지,89187,1480,1758,1480,1758,0,104
가좌2동행정복지센터,42073,5723,311,5685,311,38,194
가좌2동행정복지센터,42076,130,4767,109,4767,21,157
가좌3동행정복지센터,42075,11723,11697,11678,11697,45,755
가좌4동행정복지센터,42062,4538,6578,4524,6578,14,358
가좌고등학교,42060,12027,11023,11988,11023,39,743
가좌고등학교,42061,5176,7202,5159,7202,17,399
가좌공단,42526,22,10050,20,10050,2,324
가좌공단,42945,8007,281,7997,281,10,267
가좌교회,42055,2707,7246,2694,7246,13,321
가좌교회,42057,3264,2832,3250,2832,14,196
가좌녹지공원,42029,2000,4051,1996,4051,4,195
가좌녹지공원,42030,2188,1789,2187,1789,1,128
가좌농협,42066,8238,6295,8189,6295,49,468
가좌농협,42067,5726,6019,5701,6019,25,378
가좌동차고,42939,2221,304,2152,304,69,81
가좌동차고지,42522,134,1114,51,1114,83,40
가좌두산위브104동앞,42090,4254,3200,4246,3200,8,240
가좌사거리,42043,22,209,18,209,4,7
가좌사거리,42044,468,5054,463,5054,5,178
가좌진주아파트,42100,13294,28320,13248,28320,46,1342
가좌체육공원,42058,7238,1065,7194,1065,44,267
가좌초등학교,42069,3317,4103,3311,4103,6,239
가좌초등학교,42070,4286,2277,4281,2277,5,211
가좌테니스장,37454,2164,1024,2164,1024,0,102
가좌테니스장,37457,800,1197,799,1197,1,64
가좌현대아파트,42130,7615,1938,7607,1938,8,308
가좌현대아파트,42133,587,7766,585,7766,2,269
가좌홈플러스(쌍마아파트),42101,10718,7174,10669,7174,49,577
가좌홈플러스(쌍마아파트),42103,7517,11946,7478,11946,39,627
가좌환경사업소,42631,7726,4653,7720,4653,6,399
가좌환경사업소 북측,89341,222,359,222,359,0,18
가좌환경사업소북측,89342,19,252,19,252,0,8
가천대학교,38270,746,792,746,792,0,49
가천대학교,38284,6780,2433,6780,2433,0,297
가천대학교(노인복지회관),38269,463,831,463,831,0,41
가천의대,43237,13,50,13,50,0,2
가천의대,43897,9,2,8,2,1,0
가톨릭대,43156,3,0,3,0,0,0
가톨릭대,43325,0,55,0,55,0,1
가현오일뱅크,42734,43,15,43,15,0,1
가현중학교,42722,2381,1663,2366,1663,15,130
가현초교앞(루에블리아파트),89242,1907,3571,1892,3571,15,176
가현초교앞(센트럴타운아파트),89243,5047,1496,5026,1496,21,211
각곡,43602,2,67,2,67,0,2
각곡,43772,147,14,146,14,1,5
간석4거리,39538,244,241,242,241,2,15
간석4동새마을금고,39343,3014,5914,2984,5914,30,288
간석4동새마을금고,39346,3034,2385,3017,2385,17,174
간석4동행정복지센터,39403,3793,6736,3793,6736,0,339
간석4동행정복지센터,39412,4177,2524,4177,2524,0,216
간석금호어울림아파트,39334,24931,12831,24855,12831,76,1218
간석남부역,37429,3629,920,3629,920,0,146
간석남부역,37435,6152,2241,6108,2241,44,270
간석남부역,37529,1465,3489,1465,3489,0,159
간석동용광경로당,39394,828,580,813,580,15,45
간석래미안.자이,39333,15582,17395,15522,17395,60,1063
간석북부역,39806,4096,48,4039,48,57,133
간석북부역,39807,82,2819,41,2819,41,93
간석북부역·우성1차,39368,12180,4433,12180,4433,0,535
간석북부역·우성1차,39370,4617,9896,4617,9896,0,468
간석사거리,39413,12283,8710,12272,8710,11,677
간석사거리,39414,4568,9410,4560,9410,8,450
간석사거리,39430,2407,2412,2378,2412,29,155
간석사거리(상인천중학교),39422,11836,26931,11745,26931,91,1250
간석사거리(상인천중학교),39426,30834,18109,30734,18109,100,1578
간석시장,39434,11603,29829,11515,29829,88,1336
간석시장,39436,54006,29597,53816,29597,190,2696
간석시장,39437,14628,20717,14593,20717,35,1140
간석오거리,39460,14680,12469,14636,12469,44,875
간석오거리,39597,3903,3657,3892,3657,11,243
간석오거리(교원공제조합),39444,31691,27317,31621,27317,70,1903
간석오거리(인천웨딩홀),39406,8383,11909,8353,11909,30,654
간석오거리(인천웨딩홀),39423,33637,20286,33561,20286,76,1739
간석오거리역(7번출구),39447,16705,32239,16687,32239,18,1578
간석오거리역(8번출구),39449,59685,70676,59619,70676,66,4205
간석지구대,39535,497,642,490,642,7,36
간석지구대,39536,557,605,540,605,17,37
간석풍림아파트,92053,692,590,675,590,17,41
간석한신더휴아파트맞은편,37447,2435,529,2435,529,0,95
간재울초등학교,42347,4090,3833,4088,3833,2,255
간촌,43504,14,13,9,13,5,0
간촌,43518,29,16,29,16,0,1
갈산대동아파트,40550,367,721,367,721,0,35
갈산동아아파트,40567,1520,1596,1520,1596,0,100
갈산동입구,40622,35,2681,35,2681,0,87
갈산동천주교회,40652,755,5012,755,5012,0,186
갈산동천주교회맞은편,40650,6364,5247,6354,5247,10,374
갈산두산아파트,40544,3903,5727,3900,5727,3,310
갈산사거리,40631,2555,4848,2555,4848,0,238
갈산사거리,40634,3289,4731,3289,4731,0,258
갈산새마을금고,40635,8353,2169,8353,2169,0,339
갈산시장,40628,6993,6135,6989,6135,4,423
갈산시장.갈산도서관,40629,2095,5529,2095,5529,0,245
갈산역,40601,34874,12133,34872,12133,2,1516
갈산역,40602,10299,40154,10296,40154,3,1627
갈산역(1번출구),40604,20932,6624,20905,6624,27,888
갈산역(부평4공단)4번출구,40606,6256,16473,6245,16473,11,733
갈산주공1단지,40578,3004,2276,3004,2276,0,170
갈산주공1단지105동,40813,3993,2387,3991,2387,2,205
갈산주공2단지,40562,427,1177,427,1177,0,51
갈산주공2단지,40577,3215,6922,3212,6922,3,327
갈산태화아파트,40542,360,1086,360,1086,0,46
갈산태화아파트,40664,4605,805,4605,805,0,174
갈산태화아파트,40666,346,1473,346,1473,0,58
갈산태화아파트,40667,530,2816,530,2816,0,107
갈월초등학교,40531,88,1023,88,1023,0,35
갈현경로당,41491,25,287,25,287,0,10
갈현경로당앞,41607,202,46,202,46,0,8
갈현교,41608,3,1,3,1,0,0
갈현교,41609,0,12,0,12,0,0
갈현교입구,41492,189,26,185,26,4,6
갈현교입구,41617,5,134,5,134,0,4
갈현동마을,41351,618,549,615,549,3,37
갈현동마을,41352,171,921,170,921,1,35
갑곶돈대.강화전쟁박물관,43365,3,4,3,4,0,0
갑곶돈대.강화전쟁박물관,43728,3,7,3,7,0,0
갑곶돈대입구,43367,2,10,2,10,0,0
갑곶돈대입구,43726,16,5,16,5,0,0
갑륭초교,43374,1,4,1,4,0,0
갑륭초교,43724,10,185,10,185,0,6
갑문,35125,12,336,12,336,0,11
갑문,35504,152,10,152,10,0,5
강남시장,42172,18705,12797,18601,12797,104,1016
강남시장,42173,11336,11154,11307,11154,29,725
강남역도시에빛,31076,3917,6876,3917,6876,0,348
강남역서초현대타워앞,31016,42839,28794,42839,28794,0,2310
강남중교,43213,31,1,31,1,0,1
강남중교,43278,6,38,6,38,0,1
강서중학교,43660,0,123,0,123,0,3
강서중학교,43898,138,7,132,7,6,4
강인여객,40020,1108,1570,1104,1570,4,86
강인여객,40022,1270,813,1266,813,4,67
강화갯벌장어,43633,7,0,7,0,0,0
강화갯벌장어,43671,0,13,0,13,0,0
강화경찰서,43209,214,26,210,26,4,7
강화경찰서,43624,4,221,4,221,0,7
강화고등학교,43564,6,18,6,18,0,0
강화고등학교,43761,29,23,29,23,0,1
강화군 행복센터,43055,118,1608,117,1608,1,55
강화군 행복센터,43056,0,266,0,266,0,8
강화군노인문화센터,90373,14,24,14,24,0,1
강화군노인문화센터,90374,13,3,13,3,0,0
강화군청,43065,3329,933,3251,933,78,137
강화군청,43108,846,2891,834,2891,12,120
강화루지.강남상회,43150,136,76,134,76,2,6
강화루지.강남상회,43250,93,170,93,170,0,8
강화마니산,43001,35,53,35,53,0,2
강화마니산,43002,434,177,433,177,1,19
강화문화원.종합전시관,43097,0,51,0,51,0,1
강화문화원.종합전시관,43098,64,594,64,594,0,21
강화병원,43088,44,1475,41,1475,3,49
강화병원,43089,875,62,874,62,1,30
강화산단,90123,0,9,0,9,0,0
강화산단입구,90096,4,14,4,14,0,0
강화산단입구,90097,4,0,4,0,0,0
강화산성서문,43080,1,25,1,25,0,0
강화산성서문,43081,39,62,39,62,0,3
강화서문,43063,518,293,516,293,2,26
강화서문,43064,256,402,248,402,8,21
강화수양관앞,43467,69,38,69,38,0,3
강화수양관앞,43732,18,42,18,42,0,1
강화슈퍼,43066,578,1267,572,1267,6,59
강화슈퍼,43068,1593,528,1542,528,51,68
강화실버케어스앞,43975,24,103,24,103,0,4
강화실버케어스앞,43976,37,87,36,87,1,4
강화여자중학교,90334,0,10,0,10,0,0
강화역사박물관(고인돌),43601,340,25,328,25,12,11
강화역사박물관(고인돌),43670,15,412,15,412,0,13
강화장례식장,43918,1355,74,1327,74,28,46
강화장례식장,43946,31,1676,27,1676,4,55
강화중학교,43207,26,28,26,28,0,1
강화중학교,43623,15,52,15,52,0,2
강화터미널,43058,0,2,0,2,0,0
강화터미널,43096,44829,1680,43963,1680,866,1500
개항동 어울터,35197,8661,1652,8617,1652,44,332
개항동 어울터,35198,2021,8357,2012,8357,9,334
개화2치안센터,25023,29,1470,29,1470,0,48
개화2치안센터,25024,2006,35,2006,35,0,65
개화역1번출구.개화검문소,25030,171,6572,171,6572,0,217
개화역1번출구.개화검문소,25031,2113,272,2110,272,3,76
개화역광역환승센터,25182,1394,2332,1394,2332,0,120
갤러리84입구,35666,146,20,145,20,1,5
갤러리84입구,35667,62,156,61,156,1,7
갯벌슈퍼,43410,1,28,1,28,0,0
갯벌슈퍼,43513,14,17,14,17,0,1
거북시장,42132,12637,10722,12547,10722,90,753
거북시장,42136,11744,10137,11697,10137,47,705
거산정공.(주)록키,39137,1490,2316,1490,2316,0,122
거잠포선착장,35302,50,178,46,178,4,7
거잠포선착장,35303,128,61,128,61,0,6
거잠포회센터,35588,84,9,83,9,1,3
건설기술교육원,39353,5853,11138,5850,11138,3,548
건설기술교육원,39354,4982,3709,4981,3709,1,280
건영아파트,38069,15626,39824,15610,39824,16,1788
건일아파트,43015,387,264,386,264,1,21
건일아파트,43094,287,269,285,269,2,17
건지사거리,42882,77,1,77,1,0,2
건지사거리,42883,1,215,1,215,0,6
건평,43168,54,42,54,42,0,3
건평,43186,4,67,4,67,0,2
건평리,43187,48,16,47,16,1,2
건평리,43651,11,41,11,41,0,1
건평마을회관,43594,6,47,6,47,0,1
건평입구,43170,1,12,1,12,0,0
건평입구,43331,1,9,1,9,0,0
걸포북변역,35560,11,4146,11,4146,0,134
걸포북변역,35610,1653,95,1653,95,0,56
걸포사거리.우리병원,35561,153,298,153,298,0,14
검단1차피오레,89457,351,210,351,210,0,18
검단1차피오레,89458,43,452,43,452,0,15
검단LH행복주택,89408,12656,3608,12651,3608,5,524
검단공구상가,89053,46,735,46,735,0,25
검단공구상가,89065,490,222,490,222,0,22
검단금호아파트,42557,2,140,2,140,0,4
검단금호아파트,42558,229,461,229,461,0,22
검단노인복지관,42695,84,466,82,466,2,17
검단농기구센터,89316,94,1,89,1,5,3
검단농기구센터,89324,2,177,2,177,0,5
검단농협,42432,23680,8704,23664,8704,16,1044
검단농협,42434,5280,13356,5263,13356,17,601
검단대성베르힐,89467,2330,639,2330,639,0,95
검단동행정복지센터(검단고교),42441,2600,6288,2590,6288,10,286
검단동행정복지센터(검단고교),42445,2941,3433,2938,3433,3,205
검단디에트르리버파크,89476,791,4335,790,4335,1,165
검단디에트르리버파크,89477,3288,758,3284,758,4,130
검단로제비앙라포레,89483,2457,16,2457,16,0,79
검단로제비앙라포레,89484,2,1049,2,1049,0,33
검단로지스틱스파크,41339,1399,388,1393,388,6,57
검단로지스틱스파크,42395,381,2835,381,2835,0,103
검단메가박스,42383,1955,1716,1953,1716,2,118
검단메가박스,42384,326,966,326,966,0,41
검단모아미래도엘리트,89466,1116,4349,1116,4349,0,176
검단모아엘가그랑데아파트,42483,6971,1364,6961,1364,10,268
검단사거리역,42419,14113,14264,14100,14264,13,915
검단사거리역,42426,1737,7604,1724,7604,13,301
검단사거리역,42427,6882,2556,6837,2556,45,304
검단사거리역,42537,10496,12779,10484,12779,12,750
검단산업단지(코뿔소),42805,167,2,167,2,0,5
검단산업단지(코뿔소),42806,23,42,23,42,0,2
검단소방서,42428,996,4531,991,4531,5,178
검단소방서,42431,308,2090,302,2090,6,77
검단신도시우미린리버포레,89409,5164,11488,5150,11488,14,537
검단신안인스빌어반퍼스트,89511,2241,33,2241,33,0,73
검단신안인스빌어반퍼스트,89512,85,1580,85,1580,0,53
검단오류공단,42702,27,540,27,540,0,18
검단오류공단,42703,242,12,242,12,0,8
검단오류역,89057,6298,709,6295,709,3,226
검단오류역,89060,521,6187,521,6187,0,216
검단오류역우방아이유쉘,89067,596,1024,596,1024,0,52
검단오류역우방아이유쉘,89068,1157,314,1154,314,3,47
검단오류풍림아이원,89251,144,377,144,377,0,16
검단오류풍림아이원,89252,372,199,372,199,0,18
검단우미린파크뷰1단지,89499,1181,85,1181,85,0,40
검단우미린파크뷰1단지,89500,109,231,109,231,0,10
검단우미린파크뷰2단지,89469,4702,1626,4702,1626,0,204
검단우미린파크뷰2단지,89501,1611,3228,1611,3228,0,156
검단우방아이유쉘아파트,42688,256,391,250,391,6,20
검단원흥아파트,42400,1465,1172,1463,1172,2,85
검단원흥아파트,42401,1285,2377,1285,2377,0,118
검단지식산업센타,89054,6823,202,6818,202,5,226
검단지식산업센타,89063,207,4636,207,4636,0,156
검단초등학교,42475,7735,3068,7720,3068,15,348
검단초등학교,42482,2953,5528,2950,5528,3,273
검단초등학교,89332,103,127,98,127,5,7
검단초등학교,89333,117,179,110,179,7,9
검단출장소,42423,14043,10519,14038,10519,5,792
검단출장소,42424,4004,9329,3997,9329,7,430
검단탑종합병원,42877,405,486,405,486,0,28
검단하나아파트,42421,1902,449,1898,449,4,75
검단하나아파트,42422,310,381,304,381,6,22
검문소,43662,1,8,1,8,0,0
검문소,43812,10,84,9,84,1,3
검문소,90042,1,5,1,5,0,0
검문소,90043,19,107,18,107,1,4
검바위역,42348,3142,708,3129,708,13,124
검바위역,42349,638,4247,636,4247,2,157
검암경서동행정복지센터,42352,1751,6014,1749,6014,2,250
검암경서동행정복지센터,42353,5734,1763,5733,1763,1,241
검암사거리,42356,2338,3832,2334,3832,4,199
검암사거리,42357,4557,1980,4534,1980,23,210
검암사거리,42358,6293,2009,6293,2009,0,267
검암역(시내방면),42364,10579,404,10556,404,23,354
검암역(원당방면),42363,3480,26587,3472,26587,8,969
검암역.서해그랑블아파트,42360,5054,5551,5054,5551,0,342
검암역로열파크씨티푸르지오1단지,89167,10141,38,10073,38,68,328
검암역로열파크씨티푸르지오1단지,89168,24,8893,14,8893,10,287
검암역로열파크씨티푸르지오2단지,89169,529,61,526,61,3,19
검암역로열파크씨티푸르지오2단지,89170,41,4919,41,4919,0,160
검암역입구,42851,20073,8108,20060,8108,13,909
검암역입구,42852,9789,12351,9786,12351,3,714
검암역입구(시천교밑),89250,12226,3004,12223,3004,3,491
검암중학교,42359,3582,1896,3577,1896,5,176
검암중학교,42362,2092,2781,2092,2781,0,157
검암초등학교,42361,362,5752,362,5752,0,197
겐트대학교글로벌캠퍼스,38769,32,1,32,1,0,1
겐트대학교글로벌캠퍼스,38770,169,542,169,542,0,22
경기국제통상고.포도마을뉴서울.중앙공원,55042,550,1567,543,1567,7,68
경기국제통상고.포도마을뉴서울.중앙공원,55043,1078,840,1070,840,8,61
경기도교육청학생교육원,43162,0,95,0,95,0,3
경기도교육청학생교육원,43222,189,19,189,19,0,6
경기주유소,43051,115,411,115,411,0,16
경남1차,40343,7787,378,7702,378,85,263
경남1차아파트,40376,12814,6817,12805,6817,9,633
경남2차,40305,8297,77,8252,77,45,270
경남아너스빌,42099,2649,1500,2649,1500,0,133
경남아너스빌,42102,1351,2328,1350,2328,1,118
경남아너스빌아파트,42110,4739,3023,4736,3023,3,250
경남아너스빌아파트,42111,1643,2731,1637,2731,6,141
경남아파트,35143,7273,2360,7249,2360,24,310
경남아파트,35147,1361,2874,1343,2874,18,136
경남아파트,38281,7692,6931,7689,6931,3,471
경남아파트,41011,13662,3840,13644,3840,18,564
경남아파트,41014,3704,7500,3699,7500,5,361
경남아파트,42332,6473,3505,6466,3505,7,321
경남아파트,42334,3212,6353,3207,6353,5,308
경남아파트308동앞,40334,53,4873,53,4873,0,158
경남아파트311동앞,40300,27,5501,27,5501,0,178
경남아파트313동앞,40287,63,9026,50,9026,13,293
경동택배,89315,80,2,80,2,0,2
경동택배,89325,0,31,0,31,0,1
경명초등학교,89216,1413,562,1413,562,0,63
경명초등학교,89277,4989,7835,4989,7835,0,413
경명초등학교,89278,4342,5690,4342,5690,0,323
경방신약,39136,5140,1229,5139,1229,1,205
경방신약,39138,2456,8829,2456,8829,0,364
경복예식장,39399,9877,4888,9803,4888,74,476
경서농원,42333,76,549,76,549,0,20
경서농원,42335,31,969,31,969,0,32
경서지구입구,42303,1016,5424,1016,5424,0,207
경서지구입구,42671,2286,2349,2286,2349,0,149
경서지구입구,42672,3780,2750,3780,2750,0,210
경서초등학교,42569,3975,2478,3975,2478,0,208
경서초등학교,42570,2589,2463,2589,2463,0,162
경신마을,39646,150,163,150,163,0,10
경신마을,39982,104,832,104,832,0,30
경신아파트,41216,1696,854,1693,854,3,82
경신아파트,41223,1556,3113,1553,3113,3,150
경연초중학교,89271,5647,4390,5647,4390,0,323
경연초중학교,89272,3070,4874,3070,4874,0,256
경연초중학교·청라센텀로제비앙,89286,2394,984,2394,984,0,108
경연초중학교·호반베르디움6차,89285,1803,1953,1802,1953,1,121
경인계량소,42549,783,3,777,3,6,25
경인계량소,42550,3,583,3,583,0,18
경인교대.부평향교,41138,790,832,789,832,1,52
경인교대.부평향교,41139,701,740,699,740,2,46
경인교대역입구,41428,7263,6274,7260,6274,3,436
경인교대역입구,41429,6607,7740,6600,7740,7,462
경인교회앞,40077,921,2990,918,2990,3,126
경인방송,37003,158,145,158,145,0,9
경인방송,37004,34,299,34,299,0,10
경인산업,39688,844,1549,844,1549,0,77
경인아라뱃길여객터미널,42869,256,14,256,14,0,8
경인여대,41277,3217,3958,3217,3958,0,231
경인여대,41278,1558,2171,1556,2171,2,120
경인특장,42547,262,0,262,0,0,8
경인항다목적부두,89151,112,3,112,3,0,3
경인항다목적부두,89152,0,123,0,123,0,3
경전말,43934,39,1,37,1,2,1
경제자유구역청,38514,2343,2339,2343,2339,0,151
경제자유구역청,38515,2622,3997,2622,3997,0,213
경진브로아,39042,1144,1120,1144,1120,0,73
경흥빌라,43372,569,5,553,5,16,18
경흥빌라,43616,6,269,6,269,0,8
경희유치원앞,39991,146,483,146,483,0,20
경희유치원앞,39992,77,65,77,65,0,4
계량소,40195,2167,284,2155,284,12,79
계룡리슈빌,55225,4301,949,4301,949,0,169
계산공고,41167,2365,3542,2338,3542,27,190
계산공고,41170,4485,6633,4455,6633,30,358
계산공고앞,41169,2466,1530,2460,1530,6,128
계산국민체육센터,41276,1543,2608,1538,2608,5,133
계산국민체육센터,41613,1779,2112,1770,2112,9,125
계산동수협,41533,3400,3807,3399,3807,1,232
계산동아아파트,41231,155,1,155,1,0,5
계산동우체국,41427,7038,3016,7037,3016,1,324
계산삼거리,41196,298,247,298,247,0,17
계산삼거리(신도브래뉴),41199,9376,8667,9369,8667,7,582
계산삼거리(신도브래뉴),41201,3905,7490,3893,7490,12,367
계산시장,41176,3442,4410,3431,4410,11,253
계산여고,41576,492,563,482,563,10,34
계산여자고등학교,41221,4,122,4,122,0,4
계산여자고등학교,41224,359,882,358,882,1,40
계산역,41247,6207,4068,6198,4068,9,331
계산역,41371,3221,898,3221,898,0,132
계산역,41426,30719,20247,30699,20247,20,1644
계산역,41431,23263,30978,23246,30978,17,1749
계산우체국,41430,8963,11869,8938,11869,25,672
계산주공아파트,41423,12640,14113,12619,14113,21,863
계산중학교,41577,145,20,145,20,0,5
계양1동주민자치센터,41476,6569,1799,6545,1799,24,269
계양1동주민자치센터,41520,733,6763,723,6763,10,241
계양3동행정복지센터,41525,712,1153,712,1153,0,60
계양3동행정복지센터,41526,931,700,931,700,0,52
계양CGV,41140,3536,3828,3536,3828,0,237
계양경찰서,41184,10826,8799,10826,8799,0,633
계양경찰서,41185,6383,10036,6383,10036,0,529
계양경찰서,41195,20893,5319,20719,5319,174,845
계양경찰서·계양구청,41194,4311,17158,4280,17158,31,692
계양구의회,41123,5303,4248,5297,4248,6,308
계양구의회,41124,4993,5337,4968,5337,25,333
계양구청,41177,4423,4072,4422,4072,1,274
계양구청,41180,6570,9141,6554,9141,16,506
계양구청,41188,3735,1782,3732,1782,3,177
계양구청,41197,13,2924,13,2924,0,94
계양구청앞,41204,6821,3943,6793,3943,28,347
계양도서관,41251,4741,8522,4726,8522,15,427
계양문화회관,41248,1452,962,1452,962,0,77
계양문화회관,41255,2108,3646,2106,3646,2,185
계양산성박물관,41285,1145,1607,1139,1607,6,88
계양산성박물관,41286,706,1769,704,1769,2,79
계양산장미원 입구(계산동자연풀장),41186,706,959,706,959,0,53
계양산장미원 입구(계산동자연풀장),41189,443,849,443,849,0,41
계양산전통시장,41297,813,4370,797,4370,16,167
계양산전통시장,41298,4205,1466,4179,1466,26,182
계양산전통시장,41306,16432,16366,16382,16366,50,1058
계양산지구대,41281,840,1379,840,1379,0,71
계양산지구대,41282,661,962,656,962,5,52
계양새마을금고,41094,1486,1428,1483,1428,3,94
계양새마을금고,41097,1550,2230,1538,2230,12,121
계양세무서,41054,1386,1037,1374,1037,12,78
계양세무서,41058,791,1458,787,1458,4,72
계양센트레빌1단지,41550,4315,3965,4302,3965,13,267
계양센트레빌1단지,41627,1250,478,1250,478,0,55
계양센트레빌1단지,41628,171,852,171,852,0,33
계양센트레빌1단지(111동앞),41551,5157,4301,5156,4301,1,305
계양센트레빌2단지,41625,311,889,311,889,0,38
계양여성회관,41404,3336,4002,3324,4002,12,236
계양역,41357,175329,68688,175263,68688,66,7871
계양역,41358,59892,136709,59818,136709,74,6341
계양역(귤현역방면),41659,5444,384,5403,384,41,188
계양임광그대가아파트,41118,2777,248,2750,248,27,97
계양종합사회복지관,41120,565,1149,565,1149,0,55
계양종합사회복지관,41121,1308,671,1282,671,26,63
계양중학교,41340,343,290,340,290,3,20
계양중학교,41341,327,4983,327,4983,0,171
계양체육관(벨로드롬경기장),41440,3431,1212,3423,1212,8,149
계양체육관(벨로드롬경기장),41666,343,1120,339,1120,4,47
계양체육관(아시아드양궁장),41454,624,779,619,779,5,45
계양체육관(아시아드양궁장),41455,2178,1024,2177,1024,1,103
계양체육관(아시아드양궁장),41567,3325,895,3325,895,0,136
계양체육관(아시아드양궁장),41568,1109,5448,1109,5448,0,211
계양체육관.대동아파트,41173,10,1332,10,1332,0,43
계양효성해링턴플레이스,41669,48,1751,44,1751,4,58
고구1리입구,90006,63,25,59,25,4,2
고구1리입구,90007,10,47,10,47,0,1
고구2리마을회관입구,90014,4,98,4,98,0,3
고구2리마을회관입구,90015,120,2,112,2,8,3
고구저수지,90008,3,9,3,9,0,0
고구저수지,90009,6,3,6,3,0,0
고구촌,90012,0,38,0,38,0,1
고구촌,90013,59,1,58,1,1,1
고능2리 종점,90372,3,9,2,9,1,0
고능2리능촌마을회관,90371,0,3,0,3,0,0
고능리공소,90208,91,87,88,87,3,5
고능리입구,43291,0,53,0,53,0,1
고능리입구,43534,58,0,56,0,2,1
고다니마을9단지,80362,138,72,136,72,2,6
고려산업,39486,698,1177,698,1177,0,60
고려양행,39111,1342,1648,1342,1648,0,96
고려저수지입구,43249,31,95,31,95,0,4
고려저수지입구,43486,74,21,74,21,0,3
고비고개정상,43569,4,0,4,0,0,0
고비고개정상,43844,1,10,1,10,0,0
고산마을입구,90016,8,21,7,21,1,0
고산마을입구,90017,56,4,37,4,19,1
고산촌,43544,217,49,213,49,4,8
고산촌,43779,111,133,110,133,1,7
고상골,43269,5,58,5,58,0,2
고상골,43382,59,6,59,6,0,2
고상골입구,43266,70,3,70,3,0,2
고상골입구,43552,3,73,3,73,0,2
고속터미널,31017,10875,257,10875,257,0,359
고속터미널,31018,497,18247,497,18247,0,604
고시기(가재골),43770,9,0,9,0,0,0
고시기(가재골),90126,1,7,1,7,0,0
고염나무골,35473,10,206,8,206,2,6
고염나무골,35474,221,10,219,10,2,7
고인돌입구,43550,0,14,0,14,0,0
고인돌체육관앞,90045,113,515,111,515,2,20
고인돌체육관앞,90046,564,120,563,120,1,22
고잔고등학교,39691,134,1172,134,1172,0,42
고잔마을,43284,62,0,61,0,1,2
고잔마을,43532,1,47,1,47,0,1
고창마을.KCC,80328,370,223,370,223,0,19
고창촌,43076,25,100,24,100,1,4
고창촌입구,43166,2,3,2,3,0,0
고창촌입구,43345,1,25,1,25,0,0
고천3리마을회관,43341,89,11,88,11,1,3
고천3리마을회관,43574,14,61,12,61,2,2
고천5리마을회관,90341,5,0,3,0,2,0
고천5리마을회관,90345,0,6,0,6,0,0
고천교,43339,49,49,49,49,0,3
고천교,43849,50,13,47,13,3,2
고천당,90420,5,21,5,21,0,0
고천당,90421,13,0,13,0,0,0
고촌역,80061,3295,623,3295,623,0,126
고촌역,80062,520,5479,520,5479,0,193
고합아파트,70036,167,124,158,124,9,9
고향산천,43464,13,7,13,7,0,0
고향산천,43610,14,14,12,14,2,0
곡촌,43427,14,45,12,45,2,1
곡촌,43457,71,22,67,22,4,3
곡촌,43789,102,64,92,64,10,5
곡촌,43816,0,80,0,80,0,2
곤능,43197,3,57,3,57,0,1
곤능,43319,48,5,48,5,0,1
골드클래스,42936,161,757,160,757,1,29
공개마을,90195,30,4,30,4,0,1
공개마을,90196,0,18,0,18,0,0
공구상가,36092,455,1895,453,1895,2,75
공구상가.간동입구,80021,1184,86,1179,86,5,40
공군8547부대앞,35718,67,72,67,72,0,4
공군8547부대앞,35719,4,149,4,149,0,4
공군회관,19255,102,4,102,4,0,3
공군회관,20107,7,324,7,324,0,10
공단공구상가,92048,0,25,0,25,0,0
공단공원앞,42739,153,201,153,201,0,11
공단공원앞,42740,336,82,336,82,0,13
공단본부,42270,250,886,250,886,0,36
공단본부,42756,2892,607,2892,607,0,112
공단본부,42757,690,2549,680,2549,10,104
공단사거리,42995,10,833,10,833,0,27
공단사거리,42996,1417,10,1417,10,0,46
공단사거리,89069,40,298,40,298,0,10
공단사거리,89070,258,581,258,581,0,27
공단소방서,39062,1575,3756,1575,3756,0,171
공단시장,37426,2378,5138,2371,5138,7,242
공단시장,37427,7317,3158,7315,3158,2,337
공단오거리,40565,1763,723,1760,723,3,80
공단오거리,40566,338,2664,337,2664,1,96
공단유통상가,42940,52,1022,52,1022,0,34
공단유통상가,42941,943,60,943,60,0,32
공단자동차,42022,1637,2071,1635,2071,2,119
공단치안센터,37444,1590,893,1583,893,7,80
공단치안센터,37445,319,1543,319,1543,0,60
공단회관,39119,1573,3651,1571,3651,2,168
공단회관,39123,2961,1322,2960,1322,1,138
공덕오거리,14149,490,7,490,7,0,16
공설운동장,43091,32,524,30,524,2,17
공설운동장,43092,231,84,225,84,6,10
공수부대입구,92069,73,54,71,54,2,4
공숙입구,43290,15,53,14,53,1,2
공숙입구,43490,24,46,24,46,0,2
공영산업,89148,15,1048,15,1048,0,34
공작아파트,39479,1955,3343,1932,3343,23,170
공작아파트,39480,3024,4502,3016,4502,8,242
공장단지입구,42555,276,68,274,68,2,11
공촌마을,42323,4493,2926,4485,2926,8,239
공촌마을,42598,2306,4102,2300,4102,6,206
공촌사거리,42324,20255,10657,20255,10657,0,997
공촌사거리,42330,15507,18109,15501,18109,6,1084
공촌사거리,42331,721,612,721,612,0,43
공촌사거리(한국아파트),42322,3657,5346,3653,5346,4,290
공촌유수지체육공원,89478,39,767,38,767,1,26
공촌유수지체육공원,89479,81,155,81,155,0,7
공촌정수장,42340,131,125,131,125,0,8
공촌정수장,42341,106,198,106,198,0,9
공항고등학교,35116,1719,804,1718,804,1,81
공항교회앞,35123,1952,2347,1948,2347,4,138
공항신도시(메디컬사거리),35258,882,1509,882,1509,0,77
공항중학교,35117,1214,1188,1213,1188,1,77
공항초등학교,35087,200,352,200,352,0,17
관곡마을,90104,1,11,1,11,0,0
관곡마을,90105,22,0,22,0,0,0
관광밸트입구,43874,4,1,4,1,0,0
관교노인복지관·승학초등학교,37679,670,1047,666,1047,4,55
관교여자중학교,37226,6533,5825,6477,5825,56,398
관교여자중학교,37229,1375,2181,1369,2181,6,114
관교여자중학교,37231,1342,2315,1325,2315,17,117
관교중학교,37200,204,860,204,860,0,34
관교중학교(약수터),37202,3496,5154,3454,5154,42,279
관교중학교(약수터),37203,6137,4973,6105,4973,32,358
관리공단본부,42720,691,106,691,106,0,25
관창마을,35252,1575,731,1575,731,0,74
관창마을,35253,1414,2044,1414,2044,0,111
광명아파트,37434,13385,6335,13369,6335,16,636
광명아파트,39348,6713,13625,6710,13625,3,656
광명아파트,39835,5,925,5,925,0,30
광명아파트,40590,2452,846,2452,846,0,106
광명아파트,40817,8103,1544,8076,1544,27,311
광명아파트,41096,571,2133,571,2133,0,87
광명아파트,41098,2319,780,2305,780,14,99
광명아파트,41108,14101,20370,14094,20370,7,1111
광명아파트,41448,2348,8836,2341,8836,7,360
광명역IC진입(미정차),53043,4,0,4,0,0,0
광명역IC출입(미정차),53042,19,0,19,0,0,0
광명항,35708,46,0,46,0,0,1
광명항,35714,725,626,724,626,1,43
광명항(샘꾸미),35730,53,4,52,4,1,1
광성보,43674,22,102,21,102,1,4
광성오리,43128,6,0,6,0,0,0
광성오리,43862,0,15,0,15,0,0
광일아파트,40855,3408,1110,3393,1110,15,145
광일아파트,40874,2004,3310,2004,3310,0,171
교대역,31013,20056,19695,20056,19695,0,1282
교대입구,41141,1816,2509,1787,2509,29,139
교대입구,41142,2488,1793,2483,1793,5,138
교대후문,41362,1275,335,1274,335,1,51
교대후문,41363,337,2341,331,2341,6,86
교동중고후문,90024,1,104,1,104,0,3
교동중고후문,90025,127,17,126,17,1,4
교보생명,37357,28217,104103,28176,104103,41,4268
교산교회,43496,31,16,31,16,0,1
교산교회,43719,8,22,8,22,0,0
교산리입구,43694,22,34,20,34,2,1
교산리입구,43748,42,16,35,16,7,1
교산상회앞,43494,3,9,3,9,0,0
교산상회앞,43715,2,4,2,4,0,0
교육개발원입구,31005,809,14,809,14,0,26
교육개발원입구,31006,25,770,25,770,0,25
교통방송사거리,37538,799,2442,797,2442,2,104
교통방송사거리,37539,735,1064,735,1064,0,58
교통연수원,41191,752,2595,752,2595,0,107
교통연수원,41192,2430,1275,2430,1275,0,119
교회앞,43216,21,7,21,7,0,0
교회앞,43309,16,27,16,27,0,1
교회앞,43430,10,7,10,7,0,0
교회앞,43818,28,41,27,41,1,2
교회앞,90338,6,12,6,12,0,0
교회앞,90348,14,1,14,1,0,0
구검문소,43196,0,73,0,73,0,2
구검문소,43622,119,1,119,1,0,3
구능재,90193,16,2,12,2,4,0
구능재,90194,1,12,1,12,0,0
구도일주유소,40902,73,1297,68,1297,5,44
구두물입구,35219,299,267,299,267,0,18
구래리,80006,357,1440,356,1440,1,57
구래리,80007,1575,452,1570,452,5,65
구래역,80337,9501,18417,9487,18417,14,900
구래역,80338,20730,9463,20648,9463,82,973
구렁목,43950,217,4,212,4,5,7
구렁목,43951,3,138,3,138,0,4
구름다리,35735,3,145,3,145,0,4
구름다리,35736,7,3,7,3,0,0
구면사무소,43823,0,1,0,1,0,0
구반포역.세화고등학교,31031,916,24,916,24,0,30
구봉도입구,62035,18,297,17,297,1,10
구봉도입구,62037,333,46,324,46,9,12
구북성초교,43506,5,5,5,5,0,0
구북성초교,43656,9,11,9,11,0,0
구산사거리,40233,716,437,713,437,3,37
구산사거리,40842,431,18630,419,18630,12,614
구산사거리,40843,4191,7095,4155,7095,36,364
구산중학교,40518,566,715,555,715,11,41
구선택초교,43239,5,2,5,2,0,0
구선택초교,43896,0,5,0,5,0,0
구월1동행정복지센터,39967,933,2,927,2,6,30
구월1동행정복지센터,39981,0,378,0,378,0,12
구월2동행정복지센터,39586,3206,360,3203,360,3,115
구월2동행정복지센터,39607,332,2655,332,2655,0,96
구월도매전통시장,39192,21269,15867,21166,15867,103,1197
구월도매전통시장,39193,23755,34049,23729,34049,26,1864
구월동로데오거리,39195,4858,1131,4851,1131,7,193
구월동우체국,39211,4057,12529,4037,12529,20,535
구월동팬더아파트,39237,7760,7936,7749,7936,11,506
구월동팬더아파트,39238,8821,6476,8795,6476,26,493
구월서초등학교,39204,7876,6779,7855,6779,21,472
구월서초등학교,39205,5723,5879,5709,5879,14,374
구월아시아드1단지,39912,716,3,716,3,0,23
구월아시아드1단지,39913,2,117,0,117,2,3
구월아시아드5단지정문,39883,2710,5719,2701,5719,9,271
구월아시아드5단지후문,39881,2615,4565,2612,4565,3,231
구월아시아드6단지,39885,24850,7827,24842,7827,8,1054
구월아시아드6단지,39886,6958,18431,6954,18431,4,819
구월아시아드7단지,39892,2950,3986,2948,3986,2,223
구월아시아드8단지,39891,4848,1978,4844,1978,4,220
구월아시아드8단지,39948,51,393,51,393,0,14
구월아시아드8단지,39949,37,205,37,205,0,7
구월아시아드선수촌아파트,39202,764,678,764,678,0,46
구월아시아드선수촌아파트,39203,660,1722,660,1722,0,76
구월아시아드은빛호수공원,39914,9342,5851,9328,5851,14,490
구월아시아드은빛호수공원,39915,6568,5585,6558,5585,10,392
구월우체국,39213,8816,7602,8797,7602,19,529
구월중학교,39281,28471,18952,28342,18952,129,1529
구월중학교,39286,19040,29854,18988,29854,52,1577
구월체육공원,39384,3478,4798,3465,4798,13,266
구월초등학교,39832,1551,3428,1547,3428,4,160
구월초등학교,39833,3398,1948,3380,1948,18,172
구월한내들퍼스티지,39882,4447,1911,4446,1911,1,205
구장수파출소,39375,452,474,452,474,0,29
구재이,43282,81,13,79,13,2,3
구재이,43551,4,17,4,17,0,0
구정슈퍼앞,35498,6,76,6,76,0,2
구정슈퍼앞,35587,88,5,88,5,0,3
구정정미소,90284,2,17,2,17,0,0
구정정미소,90306,14,1,14,1,0,0
구중학교앞,44119,5,3,5,3,0,0
구중학교앞,44148,10,6,7,6,3,0
구하1리입구,43259,0,31,0,31,0,1
구하1리입구,43562,124,0,110,0,14,4
구하2리마을회관,43254,76,2,75,2,1,2
구하2리마을회관,43256,68,0,67,0,1,2
구하2리마을회관,43373,1,48,1,48,0,1
구하2리마을회관,43559,2,71,2,71,0,2
국궁장앞,70151,12,223,11,223,1,7
국립생물자원관,89111,198,600,198,600,0,25
국립생물자원관입구,42741,368,509,366,509,2,28
국립인천공항검역소,35430,34,302,32,302,2,10
국립인천공항검역소,35431,58,96,58,96,0,4
국민건강보험 인천부평지사,40620,1142,4023,1137,4023,5,166
국민건강보험 인천부평지사,40621,3500,1494,3489,1494,11,161
국민건강보험남부지사,37274,12983,11138,12937,11138,46,778
국민은행,38148,2009,5752,2007,5752,2,250
국민은행,38149,5892,2216,5888,2216,4,261
국민은행연수중앙지점,38129,4429,3534,4429,3534,0,256
국민은행연수중앙지점,38571,1683,2954,1683,2954,0,149
국제금융단지,89292,8819,6809,8819,6809,0,504
국제금융단지,89293,2789,6490,2789,6490,0,299
국제성모병원,89030,456,1644,456,1644,0,67
국제성모병원,89031,2615,1067,2615,1067,0,118
국제성모병원(종점),89369,1,138,1,138,0,4
국제업무단지(공항청사),35026,14579,4111,14540,4111,39,602
국제업무지구역,38528,2247,4005,2244,4005,3,201
국제업무지구역5번출구,38619,3303,2568,3302,2568,1,189
국제이노베이션,37573,7,1861,3,1861,4,60
국제콘크리트,90050,40,28,40,28,0,2
국제콘크리트,90051,20,129,20,129,0,4
국제학교,38457,2913,1070,2913,1070,0,128
국제학교,38462,1180,2742,1180,2742,0,126
국촌,43251,69,0,60,0,9,2
국촌,43371,7,50,7,50,0,1
국화리야영장앞,43353,67,2,60,2,7,2
국화리야영장앞,43843,1,60,1,60,0,1
국화맨션,43359,1,4,1,4,0,0
국화맨션,43566,16,3,16,3,0,0
국회연수원입구,43919,1,0,1,0,0,0
국회연수원입구,43920,0,16,0,16,0,0
군인아파트,43046,188,52,187,52,1,7
군인아파트,43047,22,133,22,133,0,5
굴다리,37142,7549,67,7549,67,0,245
굴다리오거리,40231,16644,7699,16589,7699,55,785
굴다리오거리,40232,14532,20961,14500,20961,32,1144
굴다리입구,37152,7268,3819,7228,3819,40,357
굴포천,40506,2423,2777,2423,2777,0,167
굴포천,40509,2960,3535,2959,3535,1,209
굴포천역(롯데마트),40814,42297,23538,42287,23538,10,2123
굴포천역(롯데마트),40815,18133,22449,18130,22449,3,1309
굴포천역(부평농협),40507,6012,8699,6002,8699,10,474
굴포천역(부평농협),40508,9645,6126,9629,6126,16,508
굴포천역(신복사거리),40485,4242,20914,4242,20914,0,811
굴포천역(신복사거리),40498,29557,7457,29539,7457,18,1194
굴포천역(욱일아파트),40519,4164,12462,4156,12462,8,536
굴포천역(욱일아파트),40522,8623,2632,8592,2632,31,363
궁골,43346,1,5,1,5,0,0
궁골,43572,8,0,8,0,0,0
궁현사거리,37575,1,992,1,992,0,32
궁현사거리,37576,272,4,272,4,0,8
귀뚜라미보일러,42003,4,162,4,162,0,5
귀뚜라미보일러,42004,202,0,199,0,3,6
귤현감리교회,41385,1848,4949,1840,4949,8,219
귤현감리교회,41386,3501,2591,3497,2591,4,196
귤현동마을입구,41326,301,101,295,101,6,12
귤현동마을입구,41328,62,439,59,439,3,16
귤현아이파크정문,41572,2235,409,2235,409,0,85
귤현역,41331,8841,2862,8839,2862,2,377
귤현역,41332,1253,770,1253,770,0,65
귤현차량기지(센트레빌3단지),41443,2048,617,2046,617,2,85
귤현차량기지(센트레빌3단지),41444,926,2834,922,2834,4,121
귤현차량기지(안골공원),41618,2049,2345,2049,2345,0,141
귤현차량기지(안골공원),41619,71,562,71,562,0,20
귤현차량사업소,41670,16,51,16,51,0,2
귤현현대아이파크,41620,687,2048,687,2048,0,88
그린나래지하차도,35648,25,545,24,545,1,18
그린나래지하차도,35649,1993,926,1993,926,0,94
그린빌라,42222,1695,1310,1674,1310,21,96
그린빌라,42602,1275,2536,1273,2536,2,122
그린힐아파트.e편한세상아파트,40194,341,1651,340,1651,1,64
극동.금호아파트,39272,4251,5985,4222,5985,29,330
극동.금호아파트,39278,4819,4865,4807,4865,12,312
극지연구소,39918,2056,3279,2055,3279,1,172
극지연구소,39919,4504,2498,4503,2498,1,225
근대문화거리입구,35369,1871,3842,1861,3842,10,184
근대문화거리입구,35370,2753,1815,2747,1815,6,147
근로복지공단인천병원,40145,7963,11874,7940,11874,23,639
근로복지공단인천병원,40155,18001,7774,17975,7774,26,831
글로벌캠퍼스푸르지오,39841,2337,7694,2332,7694,5,323
글로벌파크,39975,594,468,594,468,0,34
글로벌파크,39976,90,1508,90,1508,0,51
글로벌파크베르디움,39840,6627,1634,6627,1634,0,266
금강다이아몬드,39007,469,1843,469,1843,0,74
금강다이아몬드,39008,835,358,835,358,0,38
금강마을,55066,1792,2366,1765,2366,27,134
금강마을,55068,5083,754,5068,754,15,188
금강요양병원,37291,8334,5342,8303,5342,31,441
금강종합상가,42858,1091,16,1088,16,3,35
금강찜질방,44113,5,1,5,1,0,0
금강찜질방,44149,17,18,15,18,2,1
금강찜질방,44150,7,19,6,19,1,0
금강찜질방,44151,16,1,15,1,1,0
금강탱크터미널,42758,1029,2176,1029,2176,0,103
금강펜테리움더시글로,89392,8339,4972,8333,4972,6,429
금강펜테리움더시글로,89459,2666,4029,2658,4029,8,215
금곡교차로,89370,16,52,16,52,0,2
금곡동,42471,30,176,30,176,0,6
금곡동,42587,519,118,516,118,3,20
금곡종점,89319,92,73,89,73,3,5
금란마트,89056,77,901,75,901,2,31
금란마트,89061,14,321,9,321,5,10
금마초등학교,40833,5325,3319,5238,3319,87,278
금산경로당,35564,8,628,7,628,1,20
금산경로당,35565,7,2,7,2,0,0
금성목재,42812,1,191,1,191,0,6
금운교,43298,0,50,0,50,0,1
금운교,43858,2,25,1,25,1,0
금월리종점,43777,198,95,195,95,3,9
금정골입구,90301,9,13,9,13,0,0
금정부락,90300,9,7,9,7,0,0
금호2차아파트,37031,7169,1185,7148,1185,21,269
금호2차아파트,37033,1897,4777,1875,4777,22,215
금호베스트빌1단지.영종도서관,35112,1198,1709,1198,1709,0,93
금호베스트빌1단지.영종도서관,35113,3331,1222,3330,1222,1,146
금호아파트,37061,214,404,214,404,0,19
금호아파트,38302,704,888,701,888,3,51
금호아파트,38349,10895,2999,10878,2999,17,448
금호아파트,40441,2581,1325,2581,1325,0,126
금호아파트,40795,21709,19619,21700,19619,9,1333
금호아파트,40845,7501,8744,7492,8744,9,524
금호어울림,35313,3508,1164,3508,1164,0,150
금호어울림,35384,936,2922,936,2922,0,124
금호어울림,37048,1047,2252,1030,2252,17,106
금호어울림2차,35597,2,1,2,1,0,0
금호어울림2차,35598,0,1,0,1,0,0
금호어울림아파트,42137,3693,2118,3686,2118,7,187
금호어울림아파트,42139,2432,2685,2426,2685,6,165
금호어울림아파트,42592,147,1557,145,1557,2,54
금호어울림아파트,42593,1837,606,1836,606,1,78
금호이수마운트밸리,40316,514,743,511,743,3,40
금호종합열처리,42801,690,80,690,80,0,24
금호타운,37024,14230,3310,14201,3310,29,565
금호타운,37026,4562,14978,4560,14978,2,630
금홍염전,35543,601,199,598,199,3,25
금홍염전,35544,389,2937,389,2937,0,107
기계공고,37294,3529,2127,3521,2127,8,182
기계철제단지,36129,5,205,5,205,0,6
기계철제단지,36149,132,70,132,70,0,6
기신정기,39567,1023,1841,1023,1841,0,92
기업은행(구월동지점),39178,240,474,238,474,2,23
기업은행앞,70152,158,19,155,19,3,5
기점(미정차)_517 519,37677,1132,0,1132,0,0,36
긴마루교회입구,35686,98,26,97,26,1,4
긴마루교회입구,35692,11,58,11,58,0,2
길병원,39250,82786,79220,82621,79220,165,5226
길병원,39262,14066,10861,14051,10861,15,804
길병원,39264,6055,8638,6040,8638,15,473
길병원,39590,76273,70593,76127,70593,146,4737
길병원사거리,39212,20557,19063,20488,19063,69,1278
길병원사거리,39216,19008,24693,18903,24693,105,1409
길상교회,43148,53,7,52,7,1,1
길상교회,43701,9,37,9,37,0,1
길상군립어린이집,43959,55,36,53,36,2,2
길상군립어린이집,43960,33,69,33,69,0,3
길상낚시터,43149,5,11,5,11,0,0
길상낚시터,43883,1,6,1,6,0,0
길상면주민복합센터,90409,103,165,98,165,5,8
길상면주민복합센터,90410,182,220,181,220,1,12
길상보건지소,43021,208,492,207,492,1,22
길상보건지소,43069,258,297,251,297,7,17
길정저수지,90054,5,0,5,0,0,0
길정저수지,90055,10,5,10,5,0,0
길직1리,43270,100,117,97,117,3,7
길직리,43031,259,162,259,162,0,13
길직리입구,43304,8,73,7,73,1,2
길직리입구,43313,47,9,46,9,1,1
길훈4차아파트,80040,13,351,13,351,0,11
길훈4차아파트,80041,307,8,307,8,0,10
길훈아파트,42494,9029,8417,9024,8417,5,562
김미현골프장,39749,1266,802,1266,802,0,66
김미현골프장,39751,646,2033,646,2033,0,86
김소골,35675,16,38,16,38,0,1
김소골,35703,33,21,32,21,1,1
김지곡,43455,0,87,0,87,0,2
김지곡,43831,94,0,91,0,3,3
김포공항국내선,25029,1561,3037,1550,3037,11,148
김포공항국내선,25091,558,88,556,88,2,20
김포공항국제선,25006,767,4906,765,4906,2,183
김포공항국제선,25164,64,158,61,158,3,7
김포대학입구,80257,495,46,493,46,2,17
김포대학입구,80258,52,421,51,421,1,15
김포초교,80028,114,446,114,446,0,18
김포초교,80030,407,126,407,126,0,17
김포한강신협,80032,854,1136,836,1136,18,64
김포한강신협,80035,1057,1015,1049,1015,8,66
까치공원.작전도서관,41149,15041,11533,15019,11533,22,857
까치말사거리,41563,9403,3636,9403,3636,0,420
까치말사거리,41564,3611,7280,3611,7280,0,351
꿈동산.사랑마을,55022,1420,2256,1420,2256,0,118
꿈동산.사랑마을,55024,1680,114,1679,114,1,57
꿈에그린아파트,92023,3451,4130,3451,4130,0,244
나누리병원,40398,26816,21253,26777,21253,39,1550
나누리병원,40784,24919,20625,24893,20625,26,1469
나래병원,38142,3131,2199,3131,2199,0,171
나룻개,35593,43,308,43,308,0,11
나룻개,35594,256,41,253,41,3,9
나룻개입구,35385,29,308,27,308,2,10
나룻개입구,35386,267,13,266,13,1,9
나무깨,90183,4,1,4,1,0,0
나무깨,90184,2,8,2,8,0,0
나무다리,90340,0,5,0,5,0,0
나무다리,90344,9,0,9,0,0,0
나사렛국제병원앞,38068,47880,15572,47749,15572,131,2046
나은병원,42056,6613,1983,6581,1983,32,277
낚시터매점,43356,3,44,3,44,0,1
낚시터매점,43840,26,1,26,1,0,0
낚시터입구,42802,105,787,105,787,0,28
난곳정미소,90286,34,70,34,70,0,3
난정1리마을회관,90285,37,39,37,39,0,2
난정1리마을회관,90287,16,2,16,2,0,0
난정교회앞,90288,2,3,2,3,0,0
난정보건진료소앞,90289,4,8,4,8,0,0
난정초등학교입구,90305,30,3,30,3,0,1
남광로얄아파트,37257,18701,27205,18648,27205,53,1480
남광하우스토리,42841,3269,826,3266,826,3,132
남광하우스토리,42920,4125,1668,4119,1668,6,186
남광하우스토리,42921,2147,4071,2147,4071,0,200
남동I.C(문학동입구),39168,109,4011,104,4011,5,132
남동경기장,92055,265,60,261,60,4,10
남동경찰서·남촌농산물도매시장,39147,3474,1874,3457,1874,17,172
남동경찰서·남촌농산물도매시장,39148,2277,1628,2265,1628,12,125
남동고등학교,92035,81,86,81,86,0,5
남동고등학교,92036,10,84,10,84,0,3
남동공단2호공원,39075,839,5405,839,5405,0,201
남동공단근린공원앞,39073,5499,1044,5496,1044,3,211
남동공단우체국,39076,1931,6322,1931,6322,0,266
남동구청,39263,10432,8573,10431,8573,1,613
남동구청,39279,10976,9818,10973,9818,3,670
남동구청역,39318,12116,7874,12088,7874,28,644
남동구청역,39324,10964,14358,10944,14358,20,816
남동구청후문(남동등기소),39287,5166,11240,5132,11240,34,529
남동구청후문(남동등기소),39288,4369,2844,4358,2844,11,232
남동국가산업단지 입구,39853,622,13,612,13,10,20
남동국가산업단지(기신정기),39568,1619,1484,1619,1484,0,100
남동대교,38090,2472,6770,2471,6770,1,298
남동대교(스퀘어원),39063,5300,3145,5191,3145,109,272
남동빌라,39330,4693,1270,4686,1270,7,192
남동세무서,39887,21297,11548,21287,11548,10,1059
남동세무서,39888,13088,23521,13078,23521,10,1180
남동소래아트홀,39743,485,114,485,114,0,19
남동소래아트홀,39744,222,39,222,39,0,8
남동소래아트홀,39748,49,208,49,208,0,8
남동소래아트홀,39792,94,394,94,394,0,15
남동소방서,39252,1036,2538,1030,2538,6,115
남동소방서,39587,10338,6510,10276,6510,62,543
남동시범공단앞,39100,3908,5333,3908,5333,0,298
남동시범공단앞,39102,6472,2931,6472,2931,0,303
남동아시아드럭비경기장,39214,265,692,265,692,0,30
남동아시아드럭비경기장,39215,268,616,261,616,7,28
남동인더스파크역,39074,13462,2361,13459,2361,3,510
남동인더스파크역1번출구,92045,102,1,102,1,0,3
남동인더스파크역1번출구,92050,2,90,2,90,0,2
남동정수장,39372,197,623,196,623,1,26
남동중학교,39220,10869,5855,10844,5855,25,539
남동중학교,39224,4951,4807,4939,4807,12,314
남동체육관,39930,1195,860,1192,860,3,66
남동체육관,39947,711,1606,708,1606,3,74
남동체육관(체조경기장),39682,2067,2504,2062,2504,5,147
남동체육관(체조경기장),39862,1073,965,1073,965,0,65
남동초등학교,39254,16645,25688,16639,25688,6,1365
남동초등학교,39255,29612,13920,29606,13920,6,1404
남동초등학교,39265,4442,462,4408,462,34,158
남동화원,39300,5577,6245,5577,6245,0,381
남디4거리,35271,394,780,394,780,0,37
남디4거리,35280,474,409,473,409,1,28
남부고가교,40921,2,277,2,277,0,9
남산리,43324,1,0,1,0,0,0
남산리,43628,43,16,43,16,0,1
남산유스호스텔,43982,22,0,22,0,0,0
남산유스호스텔,43985,18,25,10,25,8,1
남산포입구,90030,3,46,3,46,0,1
남산포입구,90031,91,1,74,1,17,2
남성네고개,35426,45,182,45,182,0,7
남성네고개,35427,214,26,214,26,0,7
남씨농원앞,41495,13,56,13,56,0,2
남씨농원앞,41511,7,1,7,1,0,0
남양목재,42814,0,207,0,207,0,6
남인천농협백운지점,37174,203,888,203,888,0,35
남인천새마을금고중앙지점,37300,11391,15024,11344,15024,47,852
남인천여자중학교,39190,13185,5934,13142,5934,43,616
남인천여자중학교,39191,7303,14662,7282,14662,21,708
남중학교,37331,5129,482,5129,482,0,181
남중학교,37336,7094,18841,7094,18841,0,836
남청라TG,89379,113,0,113,0,0,3
남청라TG,89380,2,158,0,158,2,5
남촌농산물도매시장,92031,4928,68,4906,68,22,161
남촌농산물도매시장,92032,26,3247,26,3247,0,105
남촌농산물도매시장채소동앞,92033,52,1543,52,1543,0,51
남촌농산물도매시장채소동앞,92034,346,412,339,412,7,24
남촌동다목적센터,39908,58,1208,58,1208,0,40
남촌동다목적체육센터,39907,151,194,151,194,0,11
남촌동입구,39166,3482,9037,3480,9037,2,403
남촌입구,39156,194,543,194,543,0,23
남촌입구,39157,532,1530,532,1530,0,66
남촌풍림2차아파트,39171,5106,10740,5104,10740,2,511
남촌풍림3차아파트,39165,4092,3590,4081,3590,11,247
남촌풍림3차아파트,39167,3610,4508,3608,4508,2,261
남촌풍림아파트,39172,11626,3068,11618,3068,8,474
남항유어선부두,35078,5921,1151,5865,1151,56,228
남항유어선부두,35079,142,5205,135,5205,7,172
납섬입구,90185,8,5,8,5,0,0
납섬입구,90186,2,7,2,7,0,0
내2리마을회관앞,44138,3,0,3,0,0,0
내2리마을회관앞,44152,8,27,8,27,0,1
내3리다목적회관앞,44121,0,2,0,2,0,0
내3리다목적회관앞,44153,0,1,0,1,0,0
내3리마을회관,44154,6,0,6,0,0,0
내3리마을회관,44155,6,12,6,12,0,0
내3리마을회관,44156,7,12,7,12,0,0
내4리마을회관,44104,46,55,45,55,1,3
내4리마을회관,44157,23,20,14,20,9,1
내5리마을회관,44128,22,1,22,1,0,0
내5리마을회관,44158,2,2,2,2,0,0
내7리마을회관,44118,0,1,0,1,0,0
내7리마을회관,44159,7,6,3,6,4,0
내가면사무소(맞은편),43906,106,70,103,70,3,5
내가면사무소(사무소),43907,47,148,47,148,0,6
내가시장,43392,147,219,144,219,3,11
내가시장,43484,373,132,357,132,16,16
내가초등학교,43368,70,20,67,20,3,2
내가초등학교,43554,25,106,25,106,0,4
내건너,90167,60,43,59,43,1,3
내건너,90168,14,16,14,16,0,0
내동교회,44114,6,20,6,20,0,0
내동교회,44206,11,12,10,12,1,0
내동삼거리,44111,10,26,10,26,0,1
내리고개넘어,44102,2,0,2,0,0,0
내리교회,43395,16,12,16,12,0,0
내리교회,43543,33,50,33,50,0,2
내리쉼터,43968,0,14,0,14,0,0
내리쉼터,43972,11,1,11,1,0,0
내리어촌계사무실,44135,0,15,0,15,0,0
내리어촌계사무실,44204,1,3,1,3,0,0
내리주유소.한국화장품삼거리,57016,1528,1580,1528,1580,0,100
내리주유소.한국화장품삼거리,57018,2171,2280,2171,2280,0,143
내촌,43343,67,79,67,79,0,4
내촌,43581,64,19,64,19,0,2
내촌입구,90394,1,85,1,85,0,2
내촌입구,90395,30,37,29,37,1,2
너출(드무리입구),44086,0,2,0,2,0,0
넘말,43140,8,1,6,1,2,0
넘말,43438,0,4,0,4,0,0
넙디,35574,1814,8467,1814,8467,0,331
넙디,35575,10524,1295,10524,1295,0,381
넙디마을입구,35389,121,82,121,82,0,6
노가리해변,44105,0,1,0,1,0,0
노가리해변,44162,1,0,1,0,0,0
노랑새고개,43273,117,27,116,27,1,4
노랑새고개,43570,35,91,33,91,2,4
노인복지관,92072,1054,1053,1054,1053,0,67
노인복지관,92073,495,3453,491,3453,4,127
노인복지회관,37599,141,729,141,729,0,28
노인인력개발센터,40134,909,260,909,260,0,37
노인인력개발센터,40745,119,1132,119,1132,0,40
녹청자박물관,42668,2531,443,2529,443,2,95
녹청자박물관,42669,182,1715,182,1715,0,61
논고개길,39687,2103,2298,2095,2298,8,141
논고개길,39819,2149,1967,2144,1967,5,132
논고개길사거리,39870,215,4,212,4,3,7
논골,35318,12,16,12,16,0,0
논골,35394,23,6,23,6,0,0
논골,44098,0,4,0,4,0,0
논골,44163,1,14,1,14,0,0
논골경로당 입구,35770,3,8,3,8,0,0
논골경로당 입구,35771,0,12,0,12,0,0
논현10단지별빛마을웰카운티A정문,39121,5212,2333,5212,2333,0,243
논현10단지별빛마을웰카운티A후문,39599,875,1704,873,1704,2,83
논현12단지산뒤마을,39609,5017,12009,5004,12009,13,549
논현13단지푸르네마을,39611,3684,6837,3675,6837,9,339
논현13단지푸르네마을,39617,4433,2296,4433,2296,0,217
논현13단지푸르네마을,39618,1890,2397,1890,2397,0,138
논현14단지등대마을,39610,9475,1402,9432,1402,43,350
논현14단지등대마을휴먼시아아파트,39612,9392,3765,9340,3765,52,424
논현1동행정복지센터,39598,1595,855,1593,855,2,79
논현2단지범마을,39625,2593,10527,2588,10527,5,423
논현2동행정복지센터,39571,1212,184,1212,184,0,45
논현2동행정복지센터,39572,151,925,151,925,0,34
논현2동행정복지센터,39636,1279,2884,1279,2884,0,134
논현2동행정복지센터,39697,2599,1432,2599,1432,0,130
논현3단지하늘마을301동,39631,195,3306,195,3306,0,112
논현3단지하늘마을302동,39624,16907,5116,16888,5116,19,710
논현3단지하늘마을305동,39626,1950,4750,1950,4750,0,216
논현3단지하늘마을305동,39627,3842,2202,3842,2202,0,194
논현5단지달맞이마을,39079,8063,3201,8054,3201,9,363
논현6단지어진마을한화꿈에그린A정문,39078,3861,6745,3855,6745,6,342
논현8단지동산마을,39104,4453,1622,4453,1622,0,195
논현8단지동산마을,39569,452,440,452,440,0,28
논현8단지동산마을,39570,163,481,162,481,1,20
논현9단지냇마을신영지웰A,39101,1881,3825,1881,3825,0,184
논현9단지냇마을신영지웰A,39602,370,141,367,141,3,16
논현9단지냇마을신영지웰A,39603,40,630,34,630,6,21
논현9단지냇마을신영지웰A정문,39600,2200,1052,2195,1052,5,104
논현고잔동행정복지센터,39707,8192,12939,8184,12939,8,681
논현단풍마을트리플에듀,39582,3225,5372,3224,5372,1,277
논현단풍마을트리플에듀,39616,540,215,540,215,0,24
논현동힐스테이트,39708,19720,9735,19690,9735,30,950
논현사거리,39504,4439,4161,4432,4161,7,277
논현사거리,39505,4183,4195,4179,4195,4,270
논현센트럴뷰·에코메트로5단지,39693,557,961,557,961,0,48
논현신일해피트리아파트,39088,2247,7409,2245,7409,2,311
논현신일해피트리아파트,39089,7034,2847,7018,2847,16,318
논현역,32007,110,2933,110,2933,0,98
논현역,32008,3842,75,3842,75,0,126
논현유승한내들,39839,1497,2917,1497,2917,0,142
논현유승한내들,39923,2888,1072,2886,1072,2,127
논현주공1단지,39112,13332,6536,13329,6536,3,640
논현주공2단지,39106,11723,12073,11718,12073,5,767
논현주공아파트(인천금융고),39096,10977,9930,10977,9930,0,674
논현주공아파트(인천금융고),39098,13549,12435,13548,12435,1,838
논현중앙공원·남동논현도서관,39604,459,1988,457,1988,2,78
논현중학교,39573,917,144,917,144,0,34
논현중학교,39574,30,614,30,614,0,20
논현초등학교,39601,637,2218,630,2218,7,92
논현파크포레,39649,6065,3668,6058,3668,7,313
논현파크포레,39722,1382,3999,1380,3999,2,173
논현포대근린공원,92056,100,47,100,47,0,4
논현푸르지오.유호엔시티,39822,1905,90,1901,90,4,64
논현화훼단지,39830,111,1147,111,1147,0,40
논현화훼단지,39831,232,645,232,645,0,28
농기계은행앞,90036,0,25,0,25,0,0
농기계은행앞,90037,18,0,18,0,0,0
농도원,43178,31,66,28,66,3,3
농도원,43355,133,26,132,26,1,5
농막골,90189,11,1,11,1,0,0
농막골,90190,2,6,2,6,0,0
농산물시장,40688,3372,926,3368,926,4,138
농어바위캠핑장,44140,2,0,2,0,0,0
농어바위캠핑장,44164,24,21,24,21,0,1
농어촌공사앞,43268,134,22,133,22,1,5
농어촌공사앞,43489,22,107,21,107,1,4
농업기술센터,43357,246,89,229,89,17,10
농업기술센터,43573,61,180,60,180,1,7
농장주유소,39472,334,1055,334,1055,0,44
농장주유소,39508,232,718,232,718,0,30
농협로타리,40244,1444,2602,1444,2602,0,130
농협로타리,40248,1716,1387,1716,1387,0,100
농협로타리,40251,1408,2388,1408,2388,0,122
농협로타리,40751,4432,2874,4423,2874,9,235
농협하나로마트,44117,5,0,5,0,0,0
농협하나로마트,44165,0,8,0,8,0,0
높은마을입구,35685,47,57,46,57,1,3
높은마을입구,35693,60,48,60,48,0,3
누촌,43238,79,236,78,236,1,10
누촌,43360,199,45,198,45,1,7
뉴그린아트빌,40875,1070,806,1068,806,2,60
뉴그린아트빌,40876,181,1350,181,1350,0,49
뉴서울1차아파트,40275,12812,6679,12674,6679,138,628
뉴서울3차아파트,41026,1564,3898,1564,3898,0,176
뉴서울3차아파트,41029,8528,1116,8478,1116,50,311
뉴서울3차아파트,41032,1091,5358,1074,5358,17,208
뉴서울6차아파트,41632,1676,420,1673,420,3,67
뉴서울6차아파트,41635,506,1867,506,1867,0,76
뉴서울아파트,38303,1671,1465,1659,1465,12,101
뉴서울아파트,39234,8221,149,8192,149,29,270
뉴서울아파트,39235,177,4448,173,4448,4,149
뉴서울아파트,40505,1921,735,1878,735,43,85
뉴서울아파트,40514,568,682,567,682,1,40
뉴서울아파트,40526,2010,4231,2005,4231,5,201
뉴서울아파트,41153,6486,6312,6486,6312,0,412
뉴서울아파트,89071,8591,21451,8537,21451,54,969
느티나무,43182,18,69,18,69,0,2
느티나무,43232,61,18,60,18,1,2
늘목,35414,152,508,152,508,0,21
늘목,35415,531,83,531,83,0,19
늘목마을입구,35529,18,39,18,39,0,1
늘목마을입구,35725,15,22,15,22,0,1
늘목마을입구삼거리,35889,1,15,1,15,0,0
늘푸른벽산.서강2차,70021,15,2106,13,2106,2,68
능곡마을회관,43553,49,15,44,15,5,2
능곡마을회관,43649,13,28,13,28,0,1
능미,43921,79,7,78,7,1,2
능미,43922,8,50,7,50,1,1
능안,43276,87,53,87,53,0,4
능안,43571,23,63,23,63,0,2
능촌삼거리,90370,1,12,1,12,0,0
능촌입구,43560,16,1,15,1,1,0
능촌입구,43854,0,30,0,30,0,0
능허대공원,38567,578,909,578,909,0,47
능허대공원,38777,175,116,125,116,50,9
다남동소촌마을입구,41329,379,3,374,3,5,12
다남동소촌마을입구,41330,8,468,8,468,0,15
다남동역골입구,41333,0,214,0,214,0,6
다남동역골입구,41334,178,7,178,7,0,5
다남성결교회,41664,53,64,53,64,0,3
다남성결교회,41665,3,168,3,168,0,5
다남식당,41477,1691,16259,1682,16259,9,579
다남식당,41478,653,3118,640,3118,13,121
다리목,43717,8,13,8,13,0,0
다리목,43845,14,13,14,13,0,0
다사랑마을입구,35887,53,9,53,9,0,2
다사랑마을입구,35888,11,42,10,42,1,1
다우리농장,44083,8,0,6,0,2,0
다우리농장,44166,0,6,0,6,0,0
다운,43605,56,79,55,79,1,4
다운,43822,71,52,71,52,0,3
다운1리,43582,6,79,6,79,0,2
다운1리,43821,26,5,24,5,2,1
다운마을,43398,2,83,2,83,0,2
다운마을,43824,88,1,86,1,2,2
다임메가타운,40870,26,486,26,486,0,16
단봉초등학교,42380,3530,744,3524,744,6,137
단봉초등학교,42382,942,3129,936,3129,6,131
달빛축제공원,38620,178,169,178,169,0,11
달빛축제공원,38621,116,889,116,889,0,32
달빛축제공원대공연장,38733,252,738,252,738,0,31
달빛축제공원대공연장,38734,1043,429,1043,429,0,47
담방로사거리,39275,11984,4131,11941,4131,43,519
담방아파트,39226,419,60,417,60,2,15
당곡고개,80048,152,781,152,781,0,30
당곡고개,80049,737,68,737,68,0,25
당미마을,41552,4057,5430,4050,5430,7,306
당미마을,41553,4060,3293,4049,3293,11,237
당산리,43450,4,115,4,115,0,3
당산리,43700,143,4,141,4,2,4
당산리검문소,43699,159,14,158,14,1,5
당산리검문소,43752,6,158,6,158,0,5
당산종점,43669,0,32,0,32,0,1
당산종점,43725,38,4,38,4,0,1
당산초등학교,41418,4699,2620,4684,2620,15,236
당산초등학교,41419,1748,2121,1745,2121,3,124
당산초등학교아래사거리,41644,15,92,15,92,0,3
당산초등학교아래사거리,41645,431,218,428,218,3,20
당하대주파크빌,42392,2287,1787,2285,1787,2,131
당하동탑스빌아파트,42639,3672,2691,3669,2691,3,205
당하동행정복지센터,42886,10455,5324,10423,5324,32,509
당하메디칼,42402,1383,2142,1377,2142,6,113
당하초등학교,42396,1357,783,1354,783,3,69
당하초등학교,42399,1152,1136,1152,1136,0,73
당하탑스빌아파트,42393,2180,2441,2179,2441,1,149
당하푸르지오,42403,1156,702,1153,702,3,59
당하푸르지오,42502,741,4032,740,4032,1,153
당하풍림아파트,42405,1563,11197,1563,11197,0,411
대경화성,39789,1245,774,1244,774,1,65
대경화성,39790,1119,1779,1114,1779,5,93
대곶사거리,80008,1381,5783,1376,5783,5,231
대곶사거리,80009,6340,1456,6317,1456,23,251
대기이에스티,39013,186,330,186,330,0,16
대덕강업앞,42759,14,583,14,583,0,19
대동1차후문(종점),40553,294,659,294,659,0,30
대동도어(주),39983,608,29,608,29,0,20
대동도어(주),39984,4,861,4,861,0,27
대동아파트,37042,7704,2180,7698,2180,6,318
대동아파트,37504,4144,7151,4142,7151,2,364
대동아파트,38128,6718,10176,6699,10176,19,544
대동아파트,38345,5050,5458,5033,5458,17,338
대동아파트,39256,348,5042,344,5042,4,173
대동아파트,39473,3439,195,3374,195,65,117
대동아파트,39474,105,6793,94,6793,11,222
대동아파트,40491,541,226,534,226,7,24
대동아파트,40569,7310,2780,7309,2780,1,325
대동아파트,41172,2314,651,2314,651,0,95
대동아파트,42304,2437,3664,2425,3664,12,196
대동아파트,42306,2736,1899,2735,1899,1,149
대동아파트정문앞,40277,1073,960,1068,960,5,65
대동아파트후문,41137,2382,3935,2377,3935,5,203
대동월드,38116,4095,2595,4092,2595,3,215
대동특수철강,39049,99,1268,99,1268,0,44
대룡2리마을회관앞,90026,2,44,2,44,0,1
대룡2리마을회관앞,90027,79,0,79,0,0,2
대룡시장,90020,397,1471,396,1471,1,60
대룡시장,90021,1503,432,1470,432,33,62
대륭맨숀,40242,9335,5616,9299,5616,36,482
대륭맨숀,40247,9818,10207,9790,10207,28,645
대림3차아파트301동앞,38681,406,41,406,41,0,14
대림3차아파트301동앞,38684,27,723,27,723,0,24
대림아파트,37053,10951,4069,10948,4069,3,484
대림아파트,37054,2925,7670,2925,7670,0,341
대림아파트,38257,5553,1326,5553,1326,0,221
대림아파트,40382,3605,10711,3595,10711,10,461
대림아파트,42609,1708,1319,1696,1319,12,97
대림아파트,42610,173,2126,172,2126,1,74
대림아파트후문,40397,1897,1741,1881,1741,16,117
대명아파트,37537,2301,5885,2301,5885,0,264
대명초교,80002,1781,107,1779,107,2,60
대명초교,80003,251,1394,251,1394,0,53
대문리고개입구,43546,425,364,414,364,11,25
대문목재,89206,93,65,93,65,0,5
대문목재,89207,148,27,148,27,0,5
대문촌마을,90058,7,6,7,6,0,0
대문촌마을,90059,4,5,4,5,0,0
대박주유소,36091,2495,2492,2492,2492,3,160
대부고교차로,18388,0,6,0,6,0,0
대부관광호텔,62040,224,21,223,21,1,7
대부도서관,18389,0,39,0,39,0,1
대부도서관,18391,13,19,13,19,0,1
대부동행정복지센터,62011,321,1376,296,1376,25,54
대부동행정복지센터,62012,1364,232,1342,232,22,51
대부중고등학교,62027,242,41,235,41,7,9
대부중고등학교,62028,28,254,25,254,3,9
대부파출소앞,62036,5,66,5,66,0,2
대부파출소앞,62042,95,5,91,5,4,3
대사마을,43947,12,186,12,186,0,6
대사마을,43948,211,10,206,10,5,7
대산-기점,90259,2787,2655,2743,2655,44,175
대상스틸,89007,42,561,42,561,0,19
대성베르힐아파트(가정성당),89240,1372,3031,1363,3031,9,142
대성베르힐아파트(가정성당),89241,5448,2093,5439,2093,9,243
대성유니드아파트,40674,898,4440,898,4440,0,172
대성유니드아파트,40675,2310,397,2310,397,0,87
대신아파트,41406,5970,1812,5957,1812,13,251
대신철강,42859,15,1046,15,1046,0,34
대야초교.ABC학습타운입구,70017,298,1562,290,1562,8,60
대야초교.ABC학습타운입구,70020,1589,454,1576,454,13,65
대양자동차학원,35073,12,2130,10,2130,2,69
대우삼환아파트,38078,5489,4238,5484,4238,5,313
대우삼환아파트,38591,1455,3096,1453,3096,2,146
대우실업,41485,9,22,9,22,0,1
대우실업,41505,25,0,22,0,3,0
대우아파트,38206,4286,3624,4270,3624,16,255
대우아파트,38208,3465,3214,3462,3214,3,215
대우아파트,40321,153,339,152,339,1,15
대우아파트,40340,876,539,848,539,28,45
대우일렉트로닉스,37462,93,1629,93,1629,0,55
대우일렉트로닉스,37463,816,663,816,663,0,47
대우자동차운전학원,42262,397,280,397,280,0,21
대우자동차운전학원,42263,190,477,190,477,0,21
대우재아파트,39702,11,400,8,400,3,13
대우재아파트,39703,395,415,395,415,0,26
대우푸르지오,42407,28159,3436,28097,3436,62,1019
대우푸르지오,42842,955,3228,948,3228,7,134
대우푸르지오복합상가,39605,2774,1769,2729,1769,45,146
대우하나아파트,89073,17126,11157,17105,11157,21,912
대우하나아파트,89074,8997,10736,8987,10736,10,636
대웅실업앞,92003,55,338,55,338,0,12
대원정밀,39475,484,847,484,847,0,42
대월초등학교,90094,2,11,2,11,0,0
대월초등학교,90095,6,0,6,0,0,0
대은교회,42143,4856,8494,4839,8494,17,430
대인고등학교,42344,1360,2009,1357,2009,3,108
대인고등학교,42345,2646,1536,2639,1536,7,134
대인고등학교,89490,170,594,170,594,0,24
대일엠앤쿡,39059,859,1788,859,1788,0,85
대장간마을,43703,221,112,215,112,6,10
대정,90117,4,48,4,48,0,1
대정,90118,58,5,55,5,3,2
대주아파트,42469,1880,9936,1880,9936,0,381
대주파크빌,42466,5424,1229,5424,1229,0,214
대진아파트,40415,2581,2466,2574,2466,7,162
대촌,43393,69,69,69,69,0,4
대촌,43545,59,31,59,31,0,2
대촌마을,41663,11,0,11,0,0,0
대토단지앞,39813,998,12,998,12,0,32
대한솔루션알앤디센터,39557,43,430,43,430,0,15
대한제당,35169,1139,42,1137,42,2,38
대한제당,35220,7,1430,7,1430,0,46
대현목재,89205,217,36,217,36,0,8
대화초등학교,37397,6125,2255,6123,2255,2,270
대화초등학교,37399,2441,4644,2441,4644,0,228
대흥,43194,21,314,20,314,1,10
대흥,43591,407,29,401,29,6,14
대흥식당,35688,32,13,30,13,2,1
대흥식당,35689,32,52,32,52,0,2
더리미경로당,43363,13,15,13,15,0,0
더리미경로당,43731,20,28,20,28,0,1
더리미미술관,43961,65,25,57,25,8,2
더리미미술관,43962,7,8,7,8,0,0
더리미장어마을,43680,7,29,7,29,0,1
더리미장어마을,43864,16,3,15,3,1,0
더샵그린스퀘어105동,92021,1761,167,1757,167,4,62
더샵그린스퀘어107동,92022,133,2415,131,2415,2,82
더샵그린애비뉴,38486,9321,8137,9318,8137,3,563
더샵그린애비뉴,38510,789,29,789,29,0,26
더샵그린워크1단지,38495,4980,2159,4967,2159,13,230
더샵부평센트럴시티(101동),40061,1999,2920,1997,2920,2,158
더샵부평센트럴시티(101동),40065,2678,1244,2669,1244,9,126
더샵부평센트럴시티(127동),40050,9857,15186,9840,15186,17,807
더샵센트럴시티204동,92020,41,2043,41,2043,0,67
더샵센트럴시티205동,92019,4821,2708,4820,2708,1,242
더샵송도마리나베이,38765,17,1064,17,1064,0,34
더샵송도마리나베이,38766,958,13,958,13,0,31
더샵송도프라임뷰20단지,38561,1124,4123,1114,4123,10,169
더샵엑스포빌리지,38480,7207,2656,7206,2656,1,318
더샵퍼스트파크13단지,38601,1303,152,1301,152,2,46
더샵퍼스트파크13단지,38602,114,701,114,701,0,26
더샵하버뷰,38485,11559,8188,11559,8188,0,637
더샵하버뷰,38487,3082,1710,3070,1710,12,154
더샵하버뷰(D13),38453,1500,1084,1482,1084,18,83
더샵하버뷰(D13),38466,1392,2039,1389,2039,3,110
더샵하버뷰(D14),38454,1196,752,1191,752,5,62
더샵하버뷰14단지,38504,1532,1673,1530,1673,2,103
더월드스테이트2단지,37657,877,409,867,409,10,41
더월드스테이트후문,37422,51,743,48,743,3,25
더포레스트아파트,39876,8360,1513,8349,1513,11,318
더포레스트아파트,39877,4542,8177,4542,8177,0,410
더프라우,38410,10050,24718,10050,24718,0,1121
더필립요양병원,40461,1686,3999,1686,3999,0,183
덕고개삼거리,43723,68,28,66,28,2,3
덕고개삼거리,43750,2,58,2,58,0,1
덕골,43397,19,3,19,3,0,0
덕골,43399,19,24,18,24,1,1
덕교3거리,35012,131,48,131,48,0,5
덕교동,35003,851,153,846,153,5,32
덕교동,35005,148,1340,148,1340,0,48
덕교동,35259,1339,337,1339,337,0,54
덕교삼거리,35214,52,174,52,174,0,7
덕신고등학교(강화읍교회),90228,13,58,13,58,0,2
덕신고등학교(강화읍교회),90229,52,34,52,34,0,2
덕유마을.설악마을,11187,2874,1368,2874,1368,0,136
덕유마을.설악마을,55073,1188,723,1188,723,0,61
덕음,43657,23,6,23,6,0,0
덕응,43983,6,16,6,16,0,0
덕응,43986,6,16,6,16,0,0
덕정가든,43173,0,26,0,26,0,0
덕정가든,43296,40,1,40,1,0,1
덕진사거리,43870,44,24,44,24,0,2
덕진사거리,90310,16,11,16,11,0,0
덕진진,43637,10,39,10,39,0,1
덕진진,43672,51,6,51,6,0,1
덕창기계,39723,192,53,192,53,0,7
덕포리,43006,345,218,339,218,6,18
덕포리,43100,248,278,247,278,1,16
덕하교앞,43449,1,28,1,28,0,0
덕하교앞,43727,5,14,5,14,0,0
덕화2리,43468,53,11,53,11,0,2
덕화2리,43730,5,16,5,16,0,0
덕화2리마을회관,43923,30,8,30,8,0,1
덕화2리마을회관,43924,4,14,4,14,0,0
덕화3리마을회관,43609,144,112,144,112,0,8
덕화3리입구,43469,13,3,13,3,0,0
덕화3리입구,43729,31,44,31,44,0,2
덕화교회앞,90398,1,33,1,33,0,1
덕화교회앞,90399,17,3,17,3,0,0
도간마을,43612,45,0,43,0,2,1
도간마을,43664,0,27,0,27,0,0
도감말,43733,26,4,26,4,0,0
도감말,43754,12,8,12,8,0,0
도곡한신아파트,23504,64,56,64,56,0,3
도담공원.푸르지오더베뉴,89397,4737,1688,4737,1688,0,207
도담공원.푸르지오더베뉴,89398,2592,3883,2592,3883,0,208
도담공원·인천이음중학교(서측),89482,1675,1991,1675,1991,0,118
도두리마을,41565,16213,1759,16213,1759,0,579
도두리마을,41566,2427,12279,2427,12279,0,474
도림고등학교,92066,105,192,105,192,0,9
도림동고개,39160,1010,525,1006,525,4,49
도림동고개,39161,408,1310,408,1310,0,55
도림동입구,39140,7891,1860,7888,1860,3,314
도림동입구,39141,15,2110,15,2110,0,68
도림아이파크아파트,39155,7131,3391,7126,3391,5,339
도림육교,39154,2916,6394,2914,6394,2,300
도림주공1단지,39152,14420,11699,14395,11699,25,842
도림주공1단지,39153,13477,10115,13453,10115,24,761
도림주공208동,39142,6627,2925,6620,2925,7,308
도림주공208동,39143,4568,6510,4566,6510,2,357
도림주공2단지,39146,4249,3713,4233,3713,16,256
도림주공2단지,39149,3289,2327,3281,2327,8,181
도림주철관1공장,89307,354,681,349,681,5,33
도림주철관공업(주),42293,3728,1094,3721,1094,7,155
도림포도원,39150,319,3538,316,3538,3,124
도림포도원,39151,360,379,360,379,0,23
도원고개(도원역),36001,2799,2292,2759,2292,40,164
도원고개(동구청방향),36170,34,56,34,56,0,2
도원동행정복지센터,35180,1875,2308,1860,2308,15,134
도원동행정복지센터,36128,93,139,93,139,0,7
도원동행정복지센터(앞),35788,140,154,140,154,0,9
도원동행정복지센터(앞),35798,191,111,191,111,0,9
도원역(인천축구전용경기장),35176,6038,3856,5996,3856,42,319
도원역(인천축구전용경기장),37549,1163,2870,1157,2870,6,130
도장골삼거리,44122,2,6,2,6,0,0
도장재마을,43167,12,0,12,0,0,0
도장재마을,43225,2,21,2,21,0,0
도화1동행정복지센터,37340,11197,9654,11149,9654,48,672
도화IC,37356,23628,19197,23610,19197,18,1381
도화e편한세상604동,37578,504,67,504,67,0,18
도화e편한세상아파트,37612,222,1594,222,1594,0,58
도화e편한세상아파트,37613,4100,1537,4099,1537,1,181
도화e편한세상아파트5단지,37624,2966,861,2966,861,0,123
도화e편한세상아파트6단지,37626,1846,3699,1846,3699,0,178
도화동신협(구박문여고),36003,10633,4453,10625,4453,8,486
도화동신협(구박문여고),37499,4935,8080,4929,8080,6,419
도화사거리.도화역,37390,858,593,858,593,0,46
도화사거리.도화역,37392,254,1165,254,1165,0,45
도화사거리·더샵인천스카이타워,37673,6605,3326,6602,3326,3,320
도화사거리·더샵인천스카이타워,37674,2167,6204,2153,6204,14,270
도화서희스타힐스,37625,908,2169,908,2169,0,99
도화역,37629,5825,6403,5825,6403,0,394
도화초등학교.수봉도서관,37366,6950,6022,6928,6022,22,418
도화초등학교.수봉도서관,37367,11515,11897,11496,11897,19,755
독골사거리,42175,2923,1313,2923,1313,0,136
독배로317번길(삼거리),37634,7023,224,7023,224,0,233
독장골,43351,5,16,5,16,0,0
독장골,43846,8,2,7,2,1,0
독정역(서구동구예비군훈련장),42377,4008,3468,3997,3468,11,241
독정역(서구동구예비군훈련장),42378,8602,5456,8586,5456,16,453
독정이고개,37234,28223,19753,28117,19753,106,1547
독정이고개,37238,19064,26545,18983,26545,81,1471
돈대마을,43925,31,4,30,4,1,1
돈대마을,43926,4,13,4,13,0,0
돈대모루,43422,4,19,4,19,0,0
돈대모루,43447,14,13,13,13,1,0
돌머루(대산종점),43707,91,54,90,54,1,4
돌산밑,35320,182,22,182,22,0,6
돌산밑,35396,10,235,10,235,0,7
돌성,43364,39,229,37,229,2,8
돌성,43587,217,53,209,53,8,8
돌팍재삼거리,35273,643,671,643,671,0,42
돌팍재삼거리,35277,778,615,775,615,3,44
돌팍재한뿌리,35304,217,242,217,242,0,14
돌팍재한뿌리,35315,157,314,157,314,0,15
동강리,35245,111,73,111,73,0,5
동강리,35246,93,78,89,78,4,5
동강리,35317,16,64,16,64,0,2
동강리,35393,88,37,88,37,0,4
동검도삼거리,43223,2,29,2,29,0,1
동검도삼거리,43642,70,0,67,0,3,2
동검리마을회관입구,90069,0,16,0,16,0,0
동검리마을회관입구,90070,6,0,6,0,0,0
동검리입구,43856,1,18,1,18,0,0
동검리입구,43877,29,20,29,20,0,1
동검리종점,43889,66,21,66,21,0,2
동검상회,43519,0,1,0,1,0,0
동광리어,41083,1164,473,1164,473,0,52
동광리어,41084,632,2204,632,2204,0,91
동광제일교회,40411,474,541,474,541,0,32
동교동삼거리,22012,5586,44,5586,44,0,181
동교동삼거리,23033,151,4400,151,4400,0,146
동구선거관리위원회,36110,3138,9315,3105,9315,33,401
동구청,36011,602,600,602,600,0,38
동구청소년수련관.달동네박물관,36026,15799,13937,15699,13937,100,959
동국제강,36068,1895,3438,1888,3438,7,172
동국제강,36074,351,192,336,192,15,17
동국제강후문,36069,130,704,129,704,1,26
동국제강후문,36070,1038,117,1037,117,1,37
동남스포피아,38226,8820,7000,8812,7000,8,510
동남스포피아,38227,10004,8351,9988,8351,16,592
동남아파트,38267,977,4974,977,4974,0,191
동남아파트,38268,2014,910,2014,910,0,94
동남아파트,70039,570,581,561,581,9,37
동남아파트(무지개아파트),38337,978,3434,801,3434,177,142
동녘개,90147,0,12,0,12,0,0
동녘개,90148,37,10,37,10,0,1
동녘마을입구,39660,15,657,15,657,0,21
동들머리,43705,7,5,7,5,0,0
동들머리,43885,12,19,11,19,1,1
동막교회,43499,8,32,8,32,0,1
동막교회,43514,35,6,35,6,0,1
동막역(1번출구),38039,34837,53043,34790,53043,47,2834
동막역(3번출구),38433,48706,26737,48686,26737,20,2433
동막역(4번출구),38338,10221,987,10219,987,2,361
동막초등학교,38054,877,3186,875,3186,2,131
동막해변,43408,81,183,80,183,1,8
동막해변,43511,253,61,248,61,5,10
동문아파트,42436,13502,13621,13487,13621,15,874
동방중학교,92038,49,104,49,104,0,4
동방초등학교,92037,14,87,14,87,0,3
동보2차아파트,41053,32,630,32,630,0,21
동보2차아파트,41059,865,78,853,78,12,30
동보노빌리티,35488,3012,2990,3012,2990,0,193
동보노빌리티,35489,3377,2627,3377,2627,0,193
동보아파트,39125,2517,4932,2517,4932,0,240
동보아파트,39126,5169,1598,5169,1598,0,218
동보아파트,41056,3727,432,3727,432,0,134
동보아파트,41063,697,3400,697,3400,0,132
동보아파트,41136,364,1038,360,1038,4,45
동보아파트,41143,12252,16049,12216,16049,36,912
동보아파트,70040,314,659,300,659,14,31
동보아파트후문,41129,1132,309,1124,309,8,46
동부아파트,36052,1319,2401,1296,2401,23,120
동부아파트,37192,510,491,510,491,0,32
동산고,36018,8377,2963,8363,2963,14,365
동산고등학교,36021,4250,9447,4243,9447,7,441
동산교회,36010,1664,2767,1656,2767,8,142
동산교회,36012,3022,3412,3016,3412,6,207
동산교회,90303,1,1,1,1,0,0
동산리마을회관,90302,44,22,44,22,0,2
동산리입구,90291,5,5,5,5,0,0
동산리입구,90299,4,0,4,0,0,0
동산중고등학교(인천재능대정문),36029,3789,822,3787,822,2,148
동산휴먼시아2단지,36022,2546,593,2544,593,2,101
동산휴먼시아2단지,36023,946,3783,944,3783,2,152
동서식품,40623,2595,2456,2590,2456,5,162
동서식품,40624,1792,3531,1787,3531,5,171
동성.길훈아파트,42495,2900,4622,2896,4622,4,242
동성아파트,42496,4540,1986,4534,1986,6,210
동수교회,40184,150,1081,135,1081,15,39
동수역,40108,3245,5297,3233,5297,12,275
동수역,40110,7226,5988,7198,5988,28,426
동수역,40124,1734,11367,1727,11367,7,422
동수치안센터,40188,8299,8697,8274,8697,25,548
동수치안센터,40189,11260,11521,11251,11521,9,734
동아.팬더아파트,39233,6634,9797,6611,9797,23,530
동아.팬더아파트,39236,10373,5899,10342,5899,31,524
동아2단지정문,40324,1366,522,1356,522,10,60
동아금호아파트,38344,5170,12910,5168,12910,2,583
동아금호아파트,38347,7509,2622,7495,2622,14,326
동아아파트,37248,878,1153,878,1153,0,65
동아아파트,41070,2685,942,2667,942,18,117
동아아파트,41072,740,2149,735,2149,5,93
동아아파트,41403,1177,3931,1177,3931,0,164
동아아파트,42404,3253,4096,3253,4096,0,237
동아아파트,42406,5726,2820,5726,2820,0,275
동아아파트후문,40257,2272,2711,2256,2711,16,160
동아아파트후문,40258,2578,1575,2573,1575,5,133
동아전기,42647,593,737,593,737,0,42
동아전기,42725,1102,803,1102,803,0,61
동아정밀,42037,1317,2552,1316,2552,1,124
동아풍림아파트,37037,12703,15583,12697,15583,6,912
동암국민주택,40014,3178,815,3151,815,27,128
동암국민주택,40015,649,1934,642,1934,7,83
동암남부역,40034,37656,26458,37656,26458,0,2068
동암남부역,40797,127171,107498,126705,107498,466,7569
동암남부역,40861,771,6689,771,6689,0,240
동암남부역,40862,18128,13460,18128,13460,0,1018
동암북부역,40013,30710,15583,30625,15583,85,1493
동암북부역,40035,10024,30099,9970,30099,54,1294
동암북부역광장,40800,69587,52542,69305,52542,282,3939
동암사거리,40001,13016,14681,13011,14681,5,893
동암사거리,40003,3247,5560,3236,5560,11,284
동양도서관,41522,5931,3578,5920,3578,11,306
동양도서관(휴먼빌아파트),41523,3527,4187,3517,4187,10,248
동양엔파트4단지,42820,2559,4105,2557,4105,2,214
동양엔파트4단지,42837,4142,2069,4137,2069,5,200
동양엔파트5단지,42986,2698,2957,2696,2957,2,182
동양자이입구,41554,2258,3429,2251,3429,7,183
동양자이입구,41555,2506,2073,2502,2073,4,147
동양장사거리,37301,7527,6080,7508,6080,19,438
동양주공1.2단지,41372,10592,2836,10547,2836,45,433
동양주공1.2단지,41373,2664,7144,2647,7144,17,316
동양지구1단지정문,41521,645,1781,645,1781,0,78
동양지구입구,41445,4222,396,4202,396,20,148
동양지구입구,41446,1052,5481,1052,5481,0,210
동양하이테크,42966,23,275,23,275,0,9
동원로얄듀크마리나포레,35890,1208,547,1208,547,0,56
동원로얄듀크마리나포레,35891,371,907,371,907,0,41
동원아파트,25166,201,292,199,292,2,15
동원아파트,25167,367,164,363,164,4,17
동원아파트,37376,4688,1931,4684,1931,4,213
동원아파트,37379,1661,2694,1659,2694,2,140
동인천,35188,26489,34061,26489,34061,0,1953
동인천(우리은행앞),35517,579,421,549,421,30,32
동인천동행정복지센터,35795,27,345,27,345,0,12
동인천동행정복지센터,35805,60,80,60,80,0,4
동인천역,35185,95448,43891,95223,43891,225,4494
동인천역,35187,4265,9517,4242,9517,23,444
동인천역,35191,67019,83549,66779,83549,240,4857
동인천역,35192,9697,21518,9616,21518,81,1006
동인천역북광장,36136,24783,15922,24698,15922,85,1313
동인천역북광장,36137,29529,16040,29474,16040,55,1469
동인천중학교,39229,1289,750,1281,750,8,65
동인천중학교,39230,1687,1128,1677,1128,10,90
동일방직,36031,3636,3060,3617,3060,19,216
동일방직,36032,3335,2769,3319,2769,16,196
동일아파트,35177,453,1349,443,1349,10,58
동작세무서,20005,57,391,57,391,0,14
동주농장,43349,3,12,3,12,0,0
동주농장,43401,32,3,31,3,1,1
동촌,43407,109,0,107,0,2,3
동촌,43793,5,78,5,78,0,2
동춘2동행정복지센터,38045,971,5249,968,5249,3,200
동춘2동행정복지센터,38046,4822,667,4815,667,7,177
동춘동종점,38037,331,819,317,819,14,37
동춘동차고지,38569,441,260,420,260,21,22
동춘롤러경기장,38704,230,468,228,468,2,22
동춘마을아파트,38082,5896,5578,5891,5578,5,370
동춘마을아파트,38087,2887,6661,2886,6661,1,308
동춘역,38346,32357,21223,32305,21223,52,1728
동춘역(이마트),38060,13988,615,13988,615,0,471
동춘역(이마트.스퀘어원),38070,28951,38473,28947,38473,4,2174
돼지슈퍼.간동입구,80019,86,824,86,824,0,29
두두미마을,43289,10,0,10,0,0,0
두두미마을,43869,0,11,0,11,0,0
두밀경노당,89328,10,161,10,161,0,5
두밀경노당,89331,130,6,126,6,4,4
두산아파트,40564,1895,3224,1863,3224,32,165
두산위브아파트,37043,14615,8408,14603,8408,12,742
두산위브아파트,40630,11092,532,11088,532,4,374
두산위브아파트,40648,431,1224,431,1224,0,53
두운1리마을회관앞,90047,4,57,3,57,1,1
두운1리마을회관앞,90048,32,4,32,4,0,1
두운리,43034,28,40,28,40,0,2
두운리,43540,129,201,129,201,0,10
둑실경로당,41498,0,28,0,28,0,0
둑실경로당,41514,46,0,46,0,0,1
둑실동(아라마루전망대),41494,6,42,6,42,0,1
둑실동(아라마루전망대),41512,122,1,122,1,0,3
둑실동회차지,41500,46,21,46,21,0,2
둥개마을오거리,35861,1,46,1,46,0,1
둥개마을오거리,35862,11,0,11,0,0,0
둥깨마을입구(세븐일레븐),35721,38,18,38,18,0,1
둥깨마을입구(세븐일레븐),35722,75,21,72,21,3,3
둥깨마을입구(용성철강),35723,3,31,3,31,0,1
둥깨마을입구(용성철강),35724,7,3,7,3,0,0
뒤골입구,35668,32,1,32,1,0,1
뒤골입구,35669,2,17,2,17,0,0
뒷골 입구,90377,4,11,4,11,0,0
뒷골 입구,90380,16,0,16,0,0,0
뒷방죽들,39959,850,27,850,27,0,28
뒷방죽들,39960,6025,7808,6024,7808,1,446
드라이빙센터,35589,27,1682,27,1682,0,55
드림로갈산교,41342,250,40,250,40,0,9
드림로갈산교,41343,36,802,36,802,0,27
드림파크야생화단지,89363,2065,138,2009,138,56,71
드림파크야생화단지,89364,35,1990,6,1990,29,65
드무리해변,44011,42,519,42,519,0,18
드무리해변,44012,682,39,679,39,3,23
디에스솔텍,39035,3370,2425,3370,2425,0,186
디에스솔텍,39038,2010,2224,2010,2224,0,136
디에트로더힐,89455,4349,4902,4349,4902,0,298
디에트로더힐,89464,540,4,540,4,0,17
디에트르더힐(고산터널),89396,4031,5957,4031,5957,0,322
뗏마루어린이공원·신화아파트,39405,4441,6259,4415,6259,26,345
라마다 인천호텔,92075,191,1043,191,1043,0,39
라이크홈기숙사앞,39993,1460,1313,1460,1313,0,89
라이크홈기숙사앞,39994,2200,1414,2200,1414,0,116
라이크홈기숙사앞,39995,1052,56,1050,56,2,35
라이크홈기숙사앞,39996,23,510,23,510,0,17
라이프쇼핑앞,35070,5570,4992,5490,4992,80,340
라이프아파트,35060,147,5376,137,5376,10,178
라이프아파트,35062,12852,97,12800,97,52,417
"래미안아파트,파이낸셜뉴스",22905,6416,4222,6416,4222,0,343
래미안아파트파이낸셜뉴스,31072,959,2437,959,2437,0,109
래미안아파트파이낸셜뉴스,32002,3046,1873,3046,1873,0,158
랜드마크시티1호수변공원,38767,35,42,35,42,0,2
랜드마크시티센트럴더샵,38636,67,3285,67,3285,0,108
랜드마크시티센트럴더샵(106동),38665,954,7065,954,7065,0,258
랜드마크시티센트럴더샵(106동),38666,6885,700,6879,700,6,244
랜드마크시티센트럴더샵(203동),38645,16018,1115,16018,1115,0,552
랜드마크시티센트럴더샵(203동),38650,1103,13387,1103,13387,0,467
럭키아파트,23488,338,165,338,165,0,16
럭키아파트,38115,3963,153,3963,153,0,132
럭키아파트,38132,684,7760,684,7760,0,272
레이크파크,42840,1458,3323,1452,3323,6,154
레전드호텔,35639,1351,1755,1351,1755,0,100
레전드호텔,35640,60,312,60,312,0,12
레지던스라이크홈,92012,434,5623,434,5623,0,195
로봇랜드입구,89022,3219,68,3217,68,2,106
로봇랜드입구,89023,4,2002,4,2002,0,64
로봇타워,89301,3,581,3,581,0,18
로봇타워,89302,719,33,719,33,0,24
로얄금속,40599,5284,3462,5279,3462,5,282
로얄아파트,37247,31299,15619,31260,15619,39,1513
로얄아파트,37424,578,205,569,205,9,25
로얄타운,42047,1845,3130,1824,3130,21,160
로얄타운,42049,1930,1357,1924,1357,6,106
로얄타운,42050,1794,1529,1788,1529,6,107
로얄호텔,43542,23,38,23,38,0,1
로얄호텔,43878,18,22,16,22,2,1
롯데마트,35108,3454,4456,3453,4456,1,255
롯데마트,41390,709,14,709,14,0,23
롯데마트,41391,31,2542,31,2542,0,83
롯데마트,42829,19032,9728,19032,9728,0,927
롯데마트,42838,9469,19965,9469,19965,0,949
롯데마트계양점(고용복지센터),41227,25696,16481,25612,16481,84,1360
롯데마트계양점(고용복지센터),41424,10428,18232,10414,18232,14,924
롯데마트송도점,38523,2509,679,2506,679,3,102
롯데몰.김포공항,25174,366,1518,366,1518,0,60
롯데백화점(인천터미널),37513,172151,156176,171815,156176,336,10591
롯데백화점(인천터미널),39588,162196,117813,161932,117813,264,9032
롯데슈퍼,38072,9062,3372,9057,3372,5,401
롯데슈퍼,38074,2850,7360,2842,7360,8,329
롯데슈퍼,42206,2561,4110,2556,4110,5,215
롯데슈퍼,42207,6263,2241,6218,2241,45,274
롯데아파트,38110,7085,9205,7074,9205,11,525
롯데우람아파트,42152,4120,6509,4115,6509,5,342
롯데우람아파트,42603,3647,4629,3616,4629,31,266
롯데월드타워,37327,2305,4843,2301,4843,4,230
롯데캐슬,39795,557,287,557,287,0,27
롯데캐슬,39796,2944,1429,2944,1429,0,141
롯데캐슬,39797,443,98,443,98,0,17
롯데캐슬,39798,54,399,54,399,0,14
롯데캐슬,42835,6904,6065,6892,6065,12,418
롯데캐슬,42884,5510,10184,5504,10184,6,506
롯데캐슬,42999,779,2843,778,2843,1,116
롯데캐슬.모래내시장,39309,52398,18880,52294,18880,104,2299
롯데캐슬모래내시장,39310,27958,49339,27927,49339,31,2493
롯데캐슬캠퍼스타운,39977,13,810,13,810,0,26
롯데캐슬캠퍼스타운,39978,2595,2929,2595,2929,0,178
롯데캐슬후문,39285,4097,3927,4088,3927,9,258
루에블리아파트,89283,1955,3959,1944,3959,11,190
루에블리아파트,89284,5786,5686,5783,5686,3,370
루원더퍼스트아파트,89107,3768,6663,3765,6663,3,336
루원더퍼스트아파트,89108,8888,1823,8876,1823,12,345
루원더퍼스트아파트105동앞,89378,154,1064,154,1064,0,39
루원숲속마을,89383,392,1324,389,1324,3,55
루원숲속마을,89384,9,418,9,418,0,13
루원시티2차리더스뷰아파트,89072,13272,11484,13265,11484,7,798
루원시티사거리,89076,1472,939,1466,939,6,77
루원시티사거리,89077,422,1020,418,1020,4,46
루원시티프라디움,89150,13785,3849,13771,3849,14,568
루원시티프라디움105동,89308,8963,9740,8943,9740,20,603
루원시티프라디움105동,89309,3090,5936,3085,5936,5,291
루원이편한세상하늘채(107동),42225,12714,17734,12684,17734,30,982
루원이편한세상하늘채(112동),42721,2568,1677,2560,1677,8,136
루원이편한세상하늘채(125동),42216,4045,1995,4043,1995,2,194
루원제일풍경채정문앞,89040,3315,10173,3307,10173,8,435
루원중학교,89493,774,293,774,293,0,34
루원중학교,89494,19,300,19,300,0,10
루원지웰시티푸르지오,42228,9008,8438,8983,8438,25,562
루원호반베르디움,89149,4709,12546,4700,12546,9,556
루원호반베르디움104동,89368,943,1677,943,1677,0,84
리안월드입구,90177,36,29,36,29,0,2
리안월드입구,90178,25,23,25,23,0,1
린나이코리아,40011,7,292,4,292,3,9
린나이코리아,40012,469,0,469,0,0,15
린스트라우스,42881,7632,3306,7618,3306,14,352
린스트라우스정문,42795,6674,3938,6674,3938,0,342
린스트리우스,42831,3371,3016,3368,3016,3,206
마그네,43028,204,181,204,181,0,12
마그네다리,43158,257,152,257,152,0,13
마그네다리,43900,17,14,17,14,0,1
마그네사거리,43029,303,262,303,262,0,18
마그네사거리,43030,346,342,344,342,2,22
마니교통차고지,89496,293,4,293,4,0,9
마니산상회,43417,131,15,122,15,9,4
마니산상회,43443,47,65,47,65,0,3
마니산입구,43102,141,461,141,461,0,19
마니산입구,43103,576,197,573,197,3,24
마당개,35681,66,65,64,65,2,4
마당개,35697,75,22,75,22,0,3
마린월드,70004,891,181,858,181,33,34
마린월드,70029,7,87,1,87,6,3
마미,43747,20,15,20,15,0,1
마미,43765,7,3,7,3,0,0
마송,80131,837,3821,834,3821,3,150
마송,80132,3157,779,3135,779,22,126
마시란,35424,161,335,161,335,0,16
마시란,35425,294,76,293,76,1,11
마을금고,40528,2041,7628,2020,7628,21,311
마을회관,43314,28,0,27,0,1,0
마을회관,43773,0,8,0,8,0,0
마을회관입구,35024,581,1969,543,1969,38,82
마을회관입구,35402,1169,191,1166,191,3,43
마장공원,40286,6340,28,6303,28,37,205
마장포,35679,12,9,12,9,0,0
마장포,35699,291,41,262,41,29,10
마장포고개,35677,42,38,42,38,0,2
마장포고개,35701,71,28,71,28,0,3
마전고등학교,42752,104,4219,104,4219,0,139
마전고등학교,42753,3700,180,3700,180,0,125
마전역,42412,2714,8346,2712,8346,2,356
마전역,42413,18828,4325,18821,4325,7,746
마전주공아파트,42420,31,131,26,131,5,5
마전주공아파트,89322,0,1,0,1,0,0
마전지구1,42643,7881,52,7881,52,0,255
마전지구2,42645,17,4368,17,4368,0,141
마전지구3,42646,8,4710,8,4710,0,152
마전지구대원아파트,42481,4476,68,4476,68,0,146
마전지구대원아파트,89446,17,4573,17,4573,0,148
마전지구버스차고지,89259,3317,52,3316,52,1,108
마전지구버스차고지,89345,38,2262,36,2262,2,74
마전초등학교,42408,4485,5185,4485,5185,0,311
마포역,14001,5,519,5,519,0,16
마포역,14002,366,1,366,1,0,11
막촌,43460,338,12,317,12,21,11
막촌,43776,2,174,2,174,0,5
만석동행정복지센터,36046,3946,1476,3909,1476,37,174
만석부두,36076,382,3565,379,3565,3,127
만석부두,36079,4624,1727,4589,1727,35,204
만석비치타운,36106,655,6691,654,6691,1,236
만석비치타운,36126,1355,1117,1355,1117,0,79
만석삼거리,36185,2307,5190,2276,5190,31,241
만석삼거리,36186,954,1356,951,1356,3,74
만석주공,36057,13740,2427,13669,2427,71,521
만석초등학교,36056,647,194,628,194,19,27
만석초등학교,36187,1,147,1,147,0,4
만수1동행정복지센터,39294,12626,4692,12586,4692,40,558
만수2동행정복지센터·포레시안,39731,16133,9030,16130,9030,3,811
만수2동행정복지센터·포레시안,39735,9811,11024,9809,11024,2,672
만수3동주민센터,39425,17174,24262,17120,24262,54,1336
만수3동주민센터,39427,29762,11345,29718,11345,44,1326
만수3동주민센터,39544,507,130,502,130,5,20
만수3동주민센터,39545,70,956,70,956,0,33
만수4동주민센터,39452,6117,6339,6080,6339,37,401
만수4동주민센터,39454,6205,11318,6184,11318,21,565
만수6동주민센터입구,39277,4279,12846,4275,12846,4,552
만수7.8단지앞,39497,896,1890,888,1890,8,89
만수7.8단지앞,39635,2597,2189,2597,2189,0,154
만수북중학교,39468,1009,1796,1009,1796,0,90
만수북중학교,39469,2035,576,2035,576,0,84
만수북초등학교,39420,5547,4427,5507,4427,40,321
만수소방서,39428,8033,14448,7978,14448,55,725
만수소방서,39433,31773,11616,31692,11616,81,1399
만수신동아아파트·동인천고,39485,9126,8660,8538,8660,588,573
만수신동아아파트·동인천고,39578,515,132,500,132,15,20
만수역,39385,2612,61,2612,61,0,86
만수역,39388,354,17213,342,17213,12,566
만수종합시장,39451,26125,9226,25985,9226,140,1140
만수종합시장,39592,8596,20263,8519,20263,77,930
만수주공1단지,39401,3209,3364,3187,3364,22,212
만수주공320동앞,39431,1373,1758,1373,1758,0,101
만수주공4단지,39440,7770,5649,7750,5649,20,432
만수주공4단지,39443,9719,9149,9707,9149,12,608
만수주공정문,39408,10141,8005,10117,8005,24,585
만수주공정문,39410,3011,3285,2998,3285,13,203
만수주공후문,39435,4149,10344,4133,10344,16,467
만수주공후문,39438,13269,3922,13220,3922,49,554
만수중(대토단지),39400,204,1415,204,1415,0,52
만수중학교후문,39745,95,781,95,781,0,28
만수초등학교,39303,1542,4276,1539,4276,3,187
만수초등학교,39307,420,800,417,800,3,39
만수치안센터,39455,849,487,849,487,0,43
만월종합사회복지관,92065,1,1494,1,1494,0,48
만월중학교,39962,2056,201,2043,201,13,72
만월중학교,39963,80,2250,80,2250,0,75
만의골입구,39666,68,49,68,49,0,3
만의골입구,39672,1,46,1,46,0,1
만정낚시터,35682,48,53,48,53,0,3
만정낚시터,35696,34,31,33,31,1,2
만정낚시터입구,35683,22,78,21,78,1,3
만정낚시터입구,35695,72,13,68,13,4,2
망양돈대,90224,2,19,2,19,0,0
망양돈대,90225,16,4,16,4,0,0
망월3리,43332,199,125,192,125,7,10
망월3리,43580,0,42,0,42,0,1
망월입구,43117,3,1,3,1,0,0
망월입구,43576,12,33,11,33,1,1
망월입구,43790,13,19,13,19,0,1
망월종점,43788,6,6,5,6,1,0
매음1리마을회관,90173,17,17,17,17,0,1
매음1리마을회관,90174,24,7,22,7,2,1
매음3리마을회관(민머루),90321,9,4,9,4,0,0
매음3리마을회관(민머루),90322,6,0,6,0,0,0
매제미고개,43837,19,4,19,4,0,0
매제미고개,43988,0,6,0,6,0,0
먼우금사거리,38114,6990,5479,6974,5479,16,402
먼우금초등학교,38021,3206,11030,3206,11030,0,459
메이루즈커낼파크뷰,42747,2466,8660,2459,8660,7,358
메이루즈커낼파크뷰,42762,10022,3491,10014,3491,8,435
메이루즈커낼파크뷰정문,42794,3960,4205,3960,4205,0,263
메제미,43302,66,16,66,16,0,2
메제미,43598,31,59,31,59,0,2
면사무소입구,90018,12,181,11,181,1,6
면사무소입구,90019,123,16,117,16,6,4
면허시험장,39006,2700,2632,2700,2632,0,172
명가빌라(회차),37553,2132,2046,2109,2046,23,134
명보주택앞,43979,1,17,1,17,0,0
명보주택앞,43984,43,8,43,8,0,1
명신여자고등학교,40289,13409,4464,13399,4464,10,576
명신여자고등학교,40291,4444,8963,4434,8963,10,432
명신초등학교,43394,91,0,89,0,2,2
명신초등학교,43803,2,79,2,79,0,2
명진부페,43632,10,10,10,10,0,0
명현중학교,41405,2495,7925,2495,7925,0,336
명현초등학교,41559,6062,1875,6062,1875,0,256
명현초등학교,41560,1389,4414,1389,4414,0,187
명현초등학교(효성지구대),41069,3,1036,3,1036,0,33
모다아울렛,89190,1949,2504,1946,2504,3,143
모래내시장,39295,14131,12638,14097,12638,34,863
모래내시장,39298,12497,9936,12486,9936,11,723
모래내시장,39344,6835,5969,6835,5969,0,413
모래내시장,39350,11325,12324,11275,12324,50,762
모래내시장역(1번출구),39338,10545,9028,10514,9028,31,631
모래내시장역(2번출구),39909,9113,11701,9091,11701,22,671
모래내시장역(3번출구),39339,34867,32547,34789,32547,78,2174
모래내시장역(4번출구),39335,1972,5392,1966,5392,6,237
모래방죽사거리,89228,1539,1171,1539,1171,0,87
모래방죽사거리,89229,3564,3216,3555,3216,9,218
모름말,90255,5,1,4,1,1,0
모름말,90311,0,15,0,15,0,0
모리부락입구,90304,13,0,13,0,0,0
모아미래도,89344,2310,1550,2310,1550,0,124
모아아파트,70033,262,682,254,682,8,30
모아아파트.세종프라자,70034,690,241,680,241,10,30
모현,43659,6,251,6,251,0,8
모현,43689,253,9,249,9,4,8
목감IC진입(미정차),70226,4,0,4,0,0,0
목개마을,90153,10,7,10,7,0,0
목개마을,90154,23,14,22,14,1,1
목너머,35863,47,7,47,7,0,1
목너머,35864,1,31,1,31,0,1
목련어린이집,40824,9905,3199,9899,3199,6,422
목비고개,43032,50,102,50,102,0,4
목비고개,43272,153,127,152,127,1,9
목상교입구,41493,17,0,17,0,0,0
목상교입구,41519,0,18,0,18,0,0
목상교차로,41636,5,189,5,189,0,6
목상교차로,41637,159,2859,159,2859,0,97
목상동(새봄농원입구),41323,0,28,0,28,0,0
목상동(새봄농원입구),41324,33,18,30,18,3,1
목상동마을입구,41318,1,121,1,121,0,3
목상동마을입구,41517,106,22,106,22,0,4
목상동솔밭.이주단지입구,41316,735,58,725,58,10,25
목상동솔밭.이주단지입구,41317,55,584,55,584,0,20
목장앞,43503,1,8,1,8,0,0
목장앞,43688,2,4,2,4,0,0
목재단지,42036,350,657,349,657,1,32
목재부두사거리,42949,4,304,4,304,0,9
목재부두사거리,42960,67,50,67,50,0,3
목화빌라,37545,1,416,1,416,0,13
목화예식장,39446,13426,11705,13368,11705,58,810
목화예식장,39448,13410,18231,13352,18231,58,1020
무내미마을,39496,232,680,230,680,2,29
무내미마을,40106,157,2110,157,2110,0,73
무선내,44199,11,15,10,15,1,0
무의공영주차장,35871,5,1,5,1,0,0
무의도입구,35001,3142,197,3139,197,3,107
무의도입구,35002,425,3421,413,3421,12,124
무의도주민자치센터,35738,274,14,272,14,2,9
무의도주민자치센터,35739,12,112,12,112,0,4
무지개.한양8차아파트,40271,6317,4256,6306,4256,11,341
무지개.한양8차아파트,40276,5782,8740,5756,8740,26,468
무지개아파트,38366,3387,2386,3380,2386,7,186
무지개아파트(동남아파트),38042,4988,907,4944,907,44,190
무학리입구,90276,43,37,43,37,0,2
묵골,43498,31,11,30,11,1,1
묵골,43684,9,19,8,19,1,0
문남마을,38250,5433,3926,5432,3926,1,301
문남초등학교,38214,2127,2035,2122,2035,5,134
문남초등학교,38216,2399,3055,2396,3055,3,175
문말3거리,44084,7,0,7,0,0,0
문말3거리,44169,0,1,0,1,0,0
문말삼거리,44001,257,23,251,23,6,9
문말삼거리,44002,29,218,27,218,2,7
문산교회앞,43340,16,25,15,25,1,1
문산교회앞,43589,25,25,24,25,1,1
문산리마을회관,43101,127,299,126,299,1,13
문일여고·하우스토리만수아파트,39313,1117,4187,1117,4187,0,171
문일여고·하우스토리만수아파트,39314,5497,732,5489,732,8,200
문일여자고등학교후문,39685,1643,3201,1643,3201,0,156
문학경기장(X게임장),37643,53,84,38,84,15,4
문학경기장(박태환수영장),38310,3040,1991,3029,1991,11,162
문학경기장(박태환수영장),38311,452,3472,451,3472,1,126
문학경기장(박태환수영장),38329,1037,1265,1036,1265,1,74
문학경기장(박태환수영장),38423,748,1164,745,1164,3,61
문학경기장(야구장),37144,2079,7763,2068,7763,11,317
문학경기장(월드컵경기장),37157,2947,6755,2938,6755,9,312
문학경로당,37087,4855,2890,4855,2890,0,249
문학경로당,37088,4032,3516,4032,3516,0,243
문학고개,37056,2705,2444,2705,2444,0,166
문학고개,37057,2738,3577,2738,3577,0,203
문학고개,37101,3194,3589,3179,3589,15,218
문학우체국,37520,3454,4622,3454,4622,0,260
문학우체국,37521,4790,2747,4790,2747,0,243
문학정보고입구,37107,3569,4986,3569,4986,0,275
문학정보고입구,37108,5420,1708,5420,1708,0,229
문학초등학교,37105,16988,7353,16913,7353,75,785
문학초등학교,37110,7735,13724,7715,13724,20,692
문현,43005,84,55,84,55,0,4
문현,43164,65,41,64,41,1,3
문현,43195,144,2,140,2,4,4
문현,43321,7,135,7,135,0,4
문화교회,40173,202,237,202,237,0,14
문화교회,40174,9064,10257,9013,10257,51,623
문화예술회관,39197,3270,5915,3248,5915,22,296
문화예술회관,39199,678,709,676,709,2,44
물류단지D블럭앞,35604,368,0,368,0,0,11
물류단지F블럭앞,35603,5,522,5,522,0,17
미관광장,38508,44,162,44,162,0,6
미관광장,38512,31,32,31,32,0,2
미단교회사거리,35664,21,22,21,22,0,1
미단교회사거리,35665,3,18,3,18,0,0
미도아파트,37446,1356,1370,1356,1370,0,87
미도아파트,41027,9657,2974,9615,2974,42,407
미도아파트,41028,3462,9167,3455,9167,7,407
미래빌라,36088,6559,862,6548,862,11,239
미래빌라,36089,1431,4745,1431,4745,0,199
미래타운1.2단지,40683,3462,18846,3444,18846,18,719
미래타운1.2단지,40684,13768,2296,13761,2296,7,518
미래타운5단지,40672,840,3343,840,3343,0,134
미래타운5단지501동,40662,4650,259,4650,259,0,158
미래타운5단지505동,40669,5135,2619,5115,2619,20,250
미래테크원,92015,2732,1035,2731,1035,1,121
미루지,43420,13,6,12,6,1,0
미루지,43522,18,13,18,13,0,1
미륭아파트,36138,2952,686,2938,686,14,117
미륭아파트,36139,884,3295,879,3295,5,134
미림극장,36008,3225,7584,3210,7584,15,348
미림극장,36009,8293,2493,8222,2493,71,347
미림극장입구,36141,317,389,313,389,4,22
미산초등학교,40378,6680,8719,6666,8719,14,496
미송초등학교,38654,14666,1044,14656,1044,10,506
미송초등학교(하행),38653,1992,7250,1990,7250,2,298
미주탕,42123,2948,10864,2929,10864,19,445
미주탕,42124,10495,5062,10430,5062,65,501
미추홀경찰서(장미아파트),37524,751,3929,751,3929,0,150
미추홀공원,38368,8186,2896,8161,2896,25,357
미추홀구청,37304,5757,4176,5755,4176,2,320
미추홀구청,37307,1044,2510,1041,2510,3,114
미추홀구청입구,37306,9624,18390,9620,18390,4,903
미추홀구청입구,37312,10817,11177,10805,11177,12,709
미추홀구평생학습관,37073,5839,5966,5839,5966,0,380
미추홀도서관·인천신월초등학교,39270,3850,8024,3824,8024,26,383
미추홀서사거리,37678,253,1197,253,1197,0,46
미추홀아파트,40250,159,440,159,440,0,19
미추홀아파트,40254,179,283,179,283,0,14
미추홀외고,39689,270,548,270,548,0,26
미추홀외고,39690,345,325,341,325,4,21
미추홀퍼스트(2단지),37220,8525,3814,8478,3814,47,398
미추홀퍼스트(2단지),37642,3851,8408,3839,8408,12,395
미추홀퍼스트2단지,37646,2795,509,2795,509,0,106
미추홀퍼스트3단지,37647,669,3276,669,3276,0,127
민머루해수욕장,90336,6,4,5,4,1,0
민방위교육장,38610,82,370,82,370,0,14
민방위교육장,38611,620,438,616,438,4,34
민방위교육장,39733,7770,2324,7770,2324,0,325
민방위교육장,39734,57,2350,57,2350,0,77
민방위교육장입구,41043,1678,5596,1661,5596,17,234
바로크아파트,42530,896,558,882,558,14,46
박공현,43228,53,5,52,5,1,1
박공현,43294,15,31,15,31,0,1
박문여자고등학교,39799,399,66,399,66,0,15
박문여자고등학교,39800,85,338,84,338,1,13
박문중학교,39844,313,142,313,142,0,14
박문중학교,39847,331,2766,331,2766,0,99
박문중학교정문,39860,2736,189,2736,189,0,94
박문중학교후문,39859,191,52,191,52,0,7
박물관앞,43668,15,144,15,144,0,5
박물관앞,43698,217,20,216,20,1,7
박촌마을입구,35670,113,1,112,1,1,3
박촌마을입구,35671,4,145,4,145,0,4
박촌역,41309,15274,18156,15214,18156,60,1078
박촌역,41310,14105,10705,14086,10705,19,800
반달마을.법원.검찰청,55014,1411,4121,1407,4121,4,178
반도유보라,42904,414,1568,414,1568,0,63
반도유보라,42905,2492,435,2489,435,3,94
반도유보라,42963,2126,775,2115,775,11,93
반도유보라,42985,3259,1504,3259,1504,0,153
반디모텔,44126,12,0,12,0,0,0
반디모텔,44170,0,4,0,4,0,0
반찬단지,89426,230,221,230,221,0,14
반찬단지,89427,473,60,473,60,0,17
반포역,31034,200,2792,200,2792,0,96
반포역,31035,3924,110,3924,110,0,130
발전소삼거리,44115,33,60,31,60,2,3
발전소삼거리,44171,3,0,3,0,0,0
밝게,43990,24,1,24,1,0,0
밝게,43991,0,25,0,25,0,0
밤나무골,43022,140,77,130,77,10,7
밤나무골,43023,118,109,117,109,1,7
방개마을,90141,55,0,55,0,0,1
방개마을,90142,1,18,1,18,0,0
방아머리,62008,234,23,232,23,2,8
방아머리,62032,43,126,43,126,0,5
방아머리선착장,62007,27,292,27,292,0,10
방아머리제1주차장,62031,74,237,74,237,0,10
방아머리제1주차장,62041,294,37,287,37,7,10
방죽골,39763,2099,2612,2096,2612,3,151
방죽골,39764,631,2011,631,2011,0,85
방죽말,43027,63,73,62,73,1,4
방죽말,43214,30,116,29,116,1,4
방죽삼거리,39173,310,815,309,815,1,36
방죽삼거리,39174,493,375,487,375,6,28
방죽삼거리,42681,2025,411,2014,411,11,78
방죽삼거리,42683,921,1501,920,1501,1,78
방촌공원,40419,2744,2881,2744,2881,0,181
방축삼거리,36159,577,359,577,359,0,30
방축삼거리,36190,77,14,77,14,0,2
방파제입구,35048,5,634,3,634,2,20
방화동도시개발11단지,25026,757,60,752,60,5,26
방화중학교,25008,3265,25,3261,25,4,106
방화중학교,25009,22,823,22,823,0,27
배다리,35186,11119,19445,11097,19445,22,985
배다리삼거리,36006,12032,7399,11982,7399,50,626
배다리삼거리,36007,6811,9688,6760,9688,51,532
배다리청과물시장,35184,3698,2772,3658,2772,40,208
배다리헌책방거리,36158,477,512,477,512,0,31
배수지입구,42774,521,13,513,13,8,17
백두아파트,42632,8157,5936,8144,5936,13,454
백련사입구,43419,31,52,25,52,6,2
백련사입구,43808,45,13,45,13,0,1
백련산입구,35773,1,0,1,0,0,0
백련산입구,35778,0,27,0,27,0,0
백마장입구,40389,9493,2771,9481,2771,12,395
백마장입구,40390,2369,9457,2368,9457,1,381
백마장입구,40399,17955,18636,17936,18636,19,1180
백마장입구,40407,9631,9044,9616,9044,15,602
백병원(송림패션몰),36151,450,160,449,160,1,19
백사장회센터,62033,24,84,24,84,0,3
백사장회센터,62039,124,18,122,18,2,4
백산아파트,38112,3690,4858,3653,4858,37,275
백산아파트,38113,4441,4602,4424,4602,17,291
백산아파트,38328,1745,1587,1735,1587,10,107
백석고가(하이마트),42381,4550,3922,4542,3922,8,273
백석고가(하이마트),42578,4011,3908,4003,3908,8,255
백석마을,35096,26,51,26,51,0,2
백석중.고등학교,42374,3402,2433,3397,2433,5,188
백석중.고등학교,42375,2657,3186,2656,3186,1,188
백석중사거리,89238,1384,2135,1383,2135,1,113
백석중사거리,89239,312,4528,310,4528,2,156
백승아파트,41383,90,598,88,598,2,22
백승아파트,41384,81,186,80,186,1,8
백암왕순대앞,38483,2411,1816,2409,1816,2,136
백영아파트,40058,11011,4204,10997,4204,14,490
백영아파트,41361,8237,26,8237,26,0,266
백운곡,43040,254,113,253,113,1,11
백운곡,43295,76,224,76,224,0,9
백운공원,40072,7,619,7,619,0,20
백운공원(부평아트센터),40075,503,3689,503,3689,0,135
백운공원(부평아트센터),40076,2803,1339,2800,1339,3,133
백운역,40079,13824,20654,13790,20654,34,1112
백운역,40080,23557,18222,23532,18222,25,1347
백운역,40081,56684,51920,56601,51920,83,3503
백운역,40716,12909,2963,12891,2963,18,512
백운역(파출소),40094,73,1866,73,1866,0,62
백운역(하행),40901,2775,8020,2775,8020,0,348
백운프라자,37181,3668,9607,3654,9607,14,428
백운프라자,37185,7497,4251,7469,4251,28,378
백조아파트,40386,316,706,316,706,0,32
백조아파트,40388,1455,758,1455,758,0,71
뱃말항,44125,4,0,0,0,4,0
뱅뱅사거리,31012,6,1846,6,1846,0,59
뱅뱅사거리,32001,1916,12,1916,12,0,62
버드러지,43428,10,16,10,16,0,0
버드러지,43476,95,49,93,49,2,4
번영로제1사거리,39113,741,1626,739,1626,2,76
번영로제3사거리,39036,826,348,826,348,0,37
번영로제3사거리,39037,229,1319,229,1319,0,49
벌말,43175,3,40,2,40,1,1
벌말,43297,63,3,61,3,2,2
벌판마을입구,35763,20,158,20,158,0,5
벌판마을입구,35764,123,99,123,99,0,7
범양상가,42118,3789,9429,3788,9429,1,426
범양상가,42122,8277,2201,8264,2201,13,338
범양아파트,42116,8194,2461,8171,2461,23,343
범양아파트(종점),42127,143,2,143,2,0,4
범허리종점,43974,49,26,47,26,2,2
법원,37130,230,2074,230,2074,0,74
법원,37131,1865,929,1865,929,0,90
법원.검찰청,37074,7793,5633,7773,5633,20,433
법원.검찰청.복사골문화센터.반달마을,55020,4442,1992,4424,1992,18,207
법원검찰청입구,37078,3507,4601,3503,4601,4,261
베어즈베스트골프장,89268,333,1039,333,1039,0,44
베어즈베스트골프장,89269,237,2503,237,2503,0,88
베어즈베스트청라GC,89046,33,109,33,109,0,4
베어즈베스트청라GC,89047,48,172,48,172,0,7
벧엘교회,39740,277,1294,277,1294,0,50
벽산.이삭아파트,39453,18824,23426,18815,23426,9,1362
벽산1차아파트,70023,119,1573,118,1573,1,54
벽산1차아파트,70024,2070,310,2059,310,11,76
벽산아파트,39459,1537,22,1531,22,6,50
벽산아파트,39549,10,3133,9,3133,1,101
벽산아파트(미추홀도서관),39273,11519,4049,11455,4049,64,502
벽산이삭아파트,39458,19294,12703,19277,12703,17,1032
별립산입구,43588,0,158,0,158,0,5
별립산입구,43778,81,5,80,5,1,2
병무청(학익풍림아이원),37013,51,8,51,8,0,1
병무청(학익풍림아이원),37671,15,953,15,953,0,31
병방사거리,41301,645,2823,640,2823,5,111
병방사거리,41303,5568,1963,5538,1963,30,242
병방초등학교,41302,447,818,446,818,1,40
병방초등학교,41304,1380,1268,1373,1268,7,85
병방초등학교(계양산전통시장),41299,14711,11435,14668,11435,43,843
보건소,43318,10,10,10,10,0,0
보건소,43626,2,34,2,34,0,1
보건환경연구원,35158,1872,1700,1872,1700,0,115
보라매역.동작세무서,19013,227,10,227,10,0,7
보람프라자앞,42442,30291,17596,30262,17596,29,1544
보릿고개,43517,39,393,39,393,0,13
보릿고개,43880,264,101,263,101,1,11
보무기,90165,12,42,12,42,0,1
보무기,90166,27,14,27,14,0,1
보문사,90206,1375,1176,1345,1176,30,82
보스턴힐,89461,219,851,219,851,0,34
보스턴힐,89462,495,603,495,603,0,35
보트비,89424,20,283,20,283,0,9
보트비,89425,90,88,90,88,0,5
보훈회관,39484,4563,7239,4537,7239,26,380
복사골문화센터.한아름마을,55026,1713,3412,1709,3412,4,165
복지회관,38079,2333,1136,2330,1136,3,111
복지회관,38080,1122,3694,1118,3694,4,155
본향교회,39164,11737,2342,11705,2342,32,454
볼보트럭남인천사업소,35814,1012,1096,1011,1096,1,68
봉골,43535,29,3,29,3,0,1
봉골,43673,8,26,8,26,0,1
봉성(오상2리),43261,1,84,1,84,0,2
봉성(오상2리),43377,126,0,110,0,16,4
봉소리마을회관,43000,66,23,64,23,2,2
봉소리마을회관,90001,32,52,32,52,0,2
봉수초등학교,42980,1299,1159,1299,1159,0,79
봉수초등학교,42981,28,676,28,676,0,22
부개1동행정복지센터,40191,2362,5951,2356,5951,6,268
부개1동행정복지센터,40193,6593,4067,6567,4067,26,343
부개2동행정복지센터,40323,2993,944,2993,944,0,127
부개2파출소,40317,800,470,800,470,0,40
부개2파출소,40318,3378,8495,3345,8495,33,383
부개2파출소,40329,4389,2092,4366,2092,23,209
부개2파출소,40764,105,198,105,198,0,9
부개3동행정복지센터,40494,1449,296,1431,296,18,56
부개3동행정복지센터입구,40486,208,1198,208,1198,0,45
부개6단지후문.웅진플레이,55021,38,1771,38,1771,0,58
부개고입구,40345,1449,4316,1440,4316,9,185
부개고입구,40783,5288,1658,5263,1658,25,224
부개농협,40199,397,2029,389,2029,8,78
부개농협,40201,2317,1059,2286,1059,31,108
부개사거리,40923,397,2006,394,2006,3,77
부개서초등학교,40243,5265,817,5265,817,0,196
부개성일아파트,40293,5256,1949,5248,1949,8,232
부개성일아파트,40301,4142,7482,4130,7482,12,374
부개여자고등학교,40421,2618,1194,2614,1194,4,122
부개여자고등학교,40422,1433,2454,1426,2454,7,125
부개여자고등학교,40423,6781,4802,6781,4802,0,373
부개여자고등학교,40428,2989,4965,2989,4965,0,256
부개역,40222,1150,4085,1150,4085,0,168
부개역,40223,6841,2930,6810,2930,31,315
부개역,40256,32099,16778,32003,16778,96,1576
부개우체국,40458,8184,6721,8178,6721,6,480
부개종합시장,40504,8721,3273,8659,3273,62,386
부개주공2단지,40772,664,637,661,637,3,41
부개주공3단지,40479,2521,1209,2517,1209,4,120
부개주공3단지정문,40460,336,699,336,699,0,33
부개주공3단지후문,40500,3204,5949,3192,5949,12,295
부개주공6단지,40442,3660,2235,3655,2235,5,190
부개주공6단지,40459,4191,4106,4191,4106,0,267
부개주공7단지,40385,8908,3829,8906,3829,2,410
부개주공7단지,40387,3987,6384,3987,6384,0,334
부광여자고등학교,40471,181,525,181,525,0,22
부광초등학교,40434,1246,3582,1241,3582,5,155
부광초등학교,40440,4652,1901,4626,1901,26,211
부근삼거리,43586,559,73,551,73,8,20
부근삼거리,43652,160,477,153,477,7,20
부근삼거리,90403,2,41,2,41,0,1
부근삼거리,90404,18,5,18,5,0,0
부대아래,90106,4,9,4,9,0,0
부대아래,90107,27,2,27,2,0,0
부대앞,18392,176,5,175,5,1,5
부대앞,18397,0,52,0,52,0,1
부대앞,38594,102,376,102,376,0,15
부대앞,41321,139,321,136,321,3,14
부대앞,41322,251,1021,250,1021,1,41
부대앞,41531,48,130,48,130,0,5
부대앞,41532,97,167,97,167,0,8
부대앞,42342,365,684,365,684,0,33
부대앞,42343,188,403,188,403,0,19
부대앞,43435,21,18,21,18,0,1
부대앞,43787,53,17,53,17,0,2
부동산입구,38278,3293,1802,3293,1802,0,164
부동산입구,38743,208,661,208,661,0,28
부명고.순천향대학병원,55036,2080,6711,2075,6711,5,283
부원여중·동아아파트,40202,2092,1638,2073,1638,19,120
부원여중·동아아파트,40208,917,1852,912,1852,5,89
부원중학교,40181,21000,13896,20900,13896,100,1125
부원중학교,40789,10188,27067,10165,27067,23,1201
부일여자중학교,40123,13805,2118,13769,2118,36,513
부천IC,57023,2647,2794,2647,2794,0,175
부천IC,57025,4139,2707,4139,2707,0,220
부천시청역1번출구,55061,1844,447,1844,447,0,73
부천시청역2번출구.현대백화점.이마트,55054,16838,8540,16823,8540,15,818
부천시청역3번출구.경기예고.현대백화점,55057,5438,7797,5435,7797,3,426
부천시청역4번출구.현대백화점.경기예고,55059,7220,5362,7207,5362,13,405
부천시청역5번출구,55060,709,3327,709,3327,0,130
부천실내체육관,55075,1075,1839,1067,1839,8,94
부천오정물류단지(중),57042,494,1157,494,1157,0,53
부천오정물류단지(중),57043,677,897,677,897,0,50
부천자동차검사소,57017,1073,1468,1073,1468,0,81
부천자동차검사소,57041,1146,1783,1146,1783,0,94
부천터미널소풍,55051,2622,8274,2611,8274,11,351
부천테크노파크1.2단지,57001,1695,2011,1683,2011,12,119
부천테크노파크1단지,57003,2091,2186,2084,2186,7,137
부평2동행정복지센터,40744,198,1056,198,1056,0,40
부평4동성당,40377,3419,2471,3398,2471,21,190
부평4동성당,40922,3345,2644,3323,2644,22,193
부평6동우체국,40186,1134,424,1120,424,14,50
부평6동행정복지센터,40906,6880,372,6863,372,17,233
부평LH1(2)단지,40160,5870,7128,5845,7128,25,419
부평LH1(2)단지,40161,4744,4043,4725,4043,19,283
부평SKVIEW해모로아파트,40282,1200,1492,1200,1492,0,86
부평SKVIEW해모로아파트,40285,1425,1041,1425,1041,0,79
부평감리교회,40148,1114,441,1114,441,0,50
부평경찰서,40468,47274,18085,47253,18085,21,2108
부평경찰서,40794,14546,38901,14524,38901,22,1724
부평구보건소,40372,5780,1807,5778,1807,2,244
부평구보건소,40373,2101,6657,2101,6657,0,282
부평구보건소,40858,1938,2140,1933,2140,5,131
부평구보건소,40890,2607,3847,2572,3847,35,208
부평구자활센터,40651,16889,1798,16889,1798,0,602
부평구자활센터,40658,351,10062,350,10062,1,335
부평구청,40462,35543,26202,35487,26202,56,1991
부평구청,40482,5571,4499,5565,4499,6,324
부평구청,40484,4630,5043,4627,5043,3,312
부평구청,40492,4802,16979,4797,16979,5,702
부평구청·부평세무서,40451,28650,35951,28637,35951,13,2083
부평구청역,40841,19828,5319,19818,5319,10,811
부평기적의도서관,40497,5352,4116,5345,4116,7,305
부평기적의도서관.삼부한신아파트,40490,3213,3144,3211,3144,2,205
부평남부역,40169,3736,5420,3725,5420,11,295
부평남부역입구,40170,6619,2687,6596,2687,23,300
부평남초등학교,40141,2653,2261,2632,2261,21,158
부평남초등학교앞,40136,2580,3252,2573,3252,7,188
부평농장,39772,170,771,170,771,0,30
부평농장사무소,39483,1351,2305,1351,2305,0,117
부평농장의원입구,39494,286,489,286,489,0,25
부평도서관,40082,4361,3830,4360,3830,1,264
부평도서관,40084,2396,5015,2388,5015,8,239
부평동중,40406,2713,2705,2710,2705,3,174
부평동중,55009,2948,2274,2944,2274,4,168
부평래미안아파트,40437,2453,3662,2453,3662,0,197
부평래미안아파트,40438,5636,2240,5636,2240,0,254
부평북초등학교,40656,1261,472,1261,472,0,55
부평북초등학교,40657,785,3069,785,3069,0,124
부평사거리,40073,2767,5465,2749,5465,18,265
부평사거리,40074,11751,7729,11717,7729,34,628
부평사거리,40887,1138,5112,1115,5112,23,201
부평삼거리,39489,10486,9158,10443,9158,43,633
부평삼거리역,39491,3823,1764,3823,1764,0,180
부평삼거리역,40066,10126,8747,10100,8747,26,608
부평샬레아파트(세일고등학교),40260,1232,5819,1232,5819,0,227
부평샬레아파트(세일고등학교),40263,3616,1730,3613,1730,3,172
부평서중,40092,323,429,323,429,0,24
부평서중,40095,131,502,131,502,0,20
부평시장,40262,55612,27802,55514,27802,98,2690
부평시장,40264,22574,36528,22532,36528,42,1906
부평시장,40265,12601,7134,12583,7134,18,636
부평시장,40283,17048,11042,17023,11042,25,906
부평시장,40290,10194,8138,10182,8138,12,591
부평시장(가구의거리),40295,26194,24892,26092,24892,102,1647
부평시장(가구의거리),40296,29255,9885,29131,9885,124,1262
부평시장(당약국),40303,1153,1274,1153,1274,0,78
부평시장(용갈비),40344,6198,552,6194,552,4,217
부평시장(한남프라자),40259,15712,10531,15658,10531,54,846
부평시장(한라비발디),40328,6061,2577,5983,2577,78,278
부평시장(한라비발디),40336,9635,16629,9618,16629,17,847
부평시장역,40361,18132,48444,18088,48444,44,2147
부평시장역(부평대로우체국),40368,34407,14497,34351,14497,56,1577
부평시장입구,40288,4752,8346,4702,8346,50,422
부평시장입구(2번출구),40309,8082,10556,8047,10556,35,601
부평아트센터,40078,2445,1175,2439,1175,6,116
부평아트센터,40709,1258,3671,1245,3671,13,159
부평여자고등학교,40365,3933,1333,3880,1333,53,169
부평여자고등학교,40410,4289,6102,4254,6102,35,335
부평여자고등학교,40793,6601,7082,6580,7082,21,441
부평여자중학교,40342,164,451,164,451,0,19
부평여자중학교,40726,326,282,326,282,0,19
부평역,40190,9881,44163,9855,44163,26,1743
부평역,40209,54352,49834,54177,49834,175,3360
부평역,40226,26753,17310,26753,17310,0,1421
부평역,40228,39132,38614,39104,38614,28,2507
부평역,40234,16535,39634,16491,39634,44,1811
부평역,40237,14854,5982,14793,5982,61,672
부평역,40239,8703,9309,8703,9309,0,581
부평역,40927,1981,2444,1960,2444,21,142
부평역(12번출구),40781,33499,70715,33436,70715,63,3361
부평역(27번출구),40224,39725,7332,39538,7332,187,1517
부평역(CU편의점),40192,36096,3627,36037,3627,59,1281
부평역(대한극장),40196,14992,53845,14970,53845,22,2220
부평역(로터스프라자),40246,20605,27022,20556,27022,49,1536
부평역(북인천우체국),40197,49823,31996,49772,31996,51,2639
부평역사박물관,40597,152,555,148,555,4,22
부평역사박물관,40609,903,262,903,262,0,37
부평역사박물관,40798,472,130,472,130,0,19
부평역화성파크드림아파트,40804,894,3394,883,3394,11,138
부평역화성파크드림아파트,40805,5178,1330,5115,1330,63,209
부평우체국,40430,3914,4955,3910,4955,4,286
부평우체국,40432,6031,4432,6011,4432,20,337
부평우체국,40443,412,246,412,246,0,21
부평윤산부인과,40478,411,371,405,371,6,25
부평윤산부인과,40768,186,1527,184,1527,2,55
부평자이,40871,98,683,98,683,0,25
부평정수장,40647,1618,3249,1615,3249,3,157
부평제이타워3차지식산업센터,40644,3673,2748,3661,2748,12,207
부평중앙침례교회,40481,122,892,121,892,1,32
부평중학교,40402,3892,3700,3892,3700,0,244
부평중학교,40416,3359,3896,3359,3896,0,234
부평코오롱아파트106동,40404,756,997,756,997,0,56
부평코오롱하늘채아파트,40357,649,769,649,769,0,45
부평코오롱하늘채아파트,40360,1308,747,1308,747,0,66
부평테크노타워,40615,1660,1728,1656,1728,4,109
부평테크노타워,40616,2462,3372,2461,3372,1,188
부현동초등학교,41175,9086,4130,9051,4130,35,426
부흥로터리,40412,1521,2154,1511,2154,10,118
부흥오거리(부흥아파트),40392,5206,5371,5190,5371,16,341
부흥오거리(부흥아파트),40394,6148,4172,6133,4172,15,332
부흥오거리(소망병원),40374,5233,8841,5222,8841,11,454
부흥오거리(소망병원),40375,13589,9816,13569,9816,20,755
부흥초교,40302,7773,1754,7755,1754,18,307
부흥초등학교,40299,3323,8048,3304,8048,19,366
부흥초등학교,40304,12839,6200,12814,6200,25,614
북구도서관,40469,3076,3179,3076,3179,0,201
북동삼거리,62001,333,38,328,38,5,11
북동삼거리,62002,39,416,39,416,0,14
북변환승센터.구터미널,80080,666,62,666,62,0,23
북변환승센터.구터미널,80081,1,188,1,188,0,6
북성교회,43744,19,17,18,17,1,1
북성교회,43764,12,9,9,9,3,0
북성마을,43136,181,13,179,13,2,6
북성마을,43528,23,106,23,106,0,4
북인천여자중학교,41007,6731,5275,6714,5275,17,387
북인천여자중학교,41008,5737,6579,5729,6579,8,397
북인천여자중학교,41015,845,13136,843,13136,2,451
북인천여자중학교,41016,7437,240,7410,240,27,247
북항다목적부두,89208,15,1391,15,1391,0,45
북항다목적부두,89209,1062,23,1062,23,0,35
북항배후단지입구,89343,9,746,9,746,0,24
북항배후로입구,89414,1,61,0,61,1,2
북항사업소,89210,10,1502,10,1502,0,48
북항사업소,89211,1271,20,1271,20,0,41
북항입구,89304,435,1262,432,1262,3,54
북항입구,89305,1106,193,1101,193,5,41
분오리어판장,43406,47,14,45,14,2,1
분오리어판장,43495,5,61,5,61,0,2
분오저수지,43493,9,27,9,27,0,1
분오저수지,43509,40,10,40,10,0,1
불로대곡동행정복지센터,42497,949,946,944,946,5,61
불로대곡동행정복지센터,42498,856,2314,855,2314,1,102
불로중학교,42648,104,459,104,459,0,18
불로중학교,42652,273,485,272,485,1,24
불은면주민센터,43035,750,449,742,449,8,38
불은초등학교,43293,74,3,74,3,0,2
불은초등학교,43530,3,48,3,48,0,1
불은파출소,43036,523,746,520,746,3,40
붉은노리삼거리,44112,109,119,100,119,9,7
붉은노리삼거리,44173,1,2,1,2,0,0
브라운스톤.엠코타운아파트,40659,14132,18403,14102,18403,30,1049
블랙트리캠핑장,44124,8,33,8,33,0,1
블랙트리캠핑장,44174,22,0,19,0,3,0
블루오션골프클럽(앰코코리아),39879,9,1301,9,1301,0,42
비류마을,38261,1885,1879,1885,1879,0,121
비선삼거리,43113,3,3,3,3,0,0
비선삼거리,43114,16,5,13,5,3,0
비선삼거리,43547,178,287,177,287,1,15
비선삼거리,43596,166,141,158,141,8,9
비재고개,35420,255,86,255,86,0,11
비재고개,35421,70,258,69,258,1,10
비전교회,44200,5,9,5,9,0,0
비젼교회,40171,3165,2047,3150,2047,15,168
빈정공원,42571,1811,813,1809,813,2,84
빈정공원,42670,503,818,502,818,1,42
빈정내사거리,42327,1652,2570,1651,2570,1,136
빈정내사거리,42329,727,613,727,613,0,43
사랑마을벽산.선경.삼익아파트,55030,2116,1292,2116,1292,0,109
사리울삼거리,39128,3225,4704,3223,4704,2,255
사리울삼거리,39131,2163,2328,2158,2328,5,144
사리울중학교,39838,1382,3058,1382,3058,0,143
사리울중학교,39924,3365,1365,3362,1365,3,152
사리울초등학교후문,39713,1241,430,1239,430,2,53
사슴농장,43531,100,0,86,0,14,3
사슴농장,43866,0,73,0,73,0,2
사시미재,35731,33,4,29,4,4,1
사시미재,35732,3,46,3,46,0,1
사업.행정지원센터,35607,704,6,704,6,0,22
사업.행정지원센터,35608,30,646,30,646,0,21
사우고.김포고(걸포사거리방면),80064,3,1161,3,1161,0,37
사우고.김포시청,80024,134,2337,134,2337,0,79
사우고교.김포시청(직행),80377,900,49,900,49,0,30
사우역.김포고,35246,3144,634,3144,634,0,121
사우역.김포고(김포초교방면),80380,1310,2634,1310,2634,0,127
사원아파트입구,42777,84,118,82,118,2,6
사일로벽화,35163,32,2354,32,2354,0,76
사일로벽화,35167,1366,96,1365,96,1,47
사정,90426,6,1,6,1,0,0
사조해표,42019,1923,2066,1920,2066,3,128
사조해표,42020,955,1853,955,1853,0,90
사직(해나무),43416,0,47,0,47,0,1
사직(해나무),43797,69,1,68,1,1,2
사촌,43597,119,2,117,2,2,3
사촌,43785,0,22,0,22,0,0
삭은다리한국지엠,40524,163,2104,163,2104,0,73
삭은다리한국지엠,40525,3044,1849,3033,1849,11,157
산곡3동행정복지센터,40156,3175,556,3173,556,2,120
산곡교회,40383,7585,2854,7555,2854,30,336
산곡남초등학교,40227,1137,62,1137,62,0,38
산곡동입구(롯데마트),40779,181,1535,178,1535,3,55
산곡동입구(롯데마트),40785,11229,20060,11187,20060,42,1009
산곡동주안빌딩,40313,12258,2267,12227,2267,31,468
산곡동천주교회,40473,28137,14422,28060,14422,77,1372
산곡동천주교회,40476,9953,29867,9912,29867,41,1284
산곡여자중학교,40198,5846,7442,5822,7442,24,428
산곡여자중학교,40203,2324,2917,2321,2917,3,169
산곡여자중학교,40215,49,1480,49,1480,0,49
산곡여자중학교,40216,4512,90,4512,90,0,148
산곡여자중학교(마장로삼거리),40911,623,1380,616,1380,7,64
산곡역(1번출구),40420,5427,24605,5406,24605,21,968
산곡역(3번출구),40856,11039,5315,11009,5315,30,527
산곡역(6번출구),40429,7862,22588,7836,22588,26,982
산곡역(7번출구),40425,56812,34663,56761,34663,51,2950
산곡중학교,40320,414,118,414,118,0,17
산곡중학교,40322,98,1040,98,1040,0,36
산곡한양7차,40354,136,9308,136,9308,0,304
산뒤,43235,33,103,33,103,0,4
산뒤,43887,99,15,98,15,1,3
산림조합앞,90234,16,39,12,39,4,1
산림조합앞,90235,14,120,14,120,0,4
산마루집,41497,12,31,12,31,0,1
산마루집,41513,44,0,44,0,0,1
산마을고등학교,43116,1,17,1,17,0,0
산마을고등학교,43599,13,5,13,5,0,0
산문입구,43107,76,131,75,131,1,6
산문입구,43286,174,144,173,144,1,10
산문입구,43899,9,1,9,1,0,0
산문종점,43154,64,134,63,134,1,6
산애들애,43143,0,6,0,6,0,0
산애들애,43492,5,1,5,1,0,0
산업단지사거리,36095,39,4633,39,4633,0,150
산업단지사거리,37460,6708,349,6707,349,1,227
산업용품센타,42524,6000,528,5994,528,6,210
산업용품센타,42525,39,2827,38,2827,1,92
산업용품유통센타23동,36096,350,2055,348,2055,2,77
산업용품유통센타31동,36097,151,1965,151,1965,0,68
산업용품유통센타39동,36099,201,1982,199,1982,2,70
산업용품유통센터,36156,700,9,658,9,42,22
산업용품유통센터1동,36146,2277,373,2277,373,0,85
산업용품유통센터39동,36157,92,11,90,11,2,3
산업용품유통센터C동,36101,2064,19,2064,19,0,67
산우리고개,43337,0,11,0,11,0,0
산우리고개,43850,13,28,12,28,1,1
산음입구,80004,1,416,1,416,0,13
산음입구,80005,129,8,129,8,0,4
산촌마을,43217,3,3,3,3,0,0
산촌마을,43308,21,11,18,11,3,1
산호아파트앞,80059,1270,205,1270,205,0,47
산화고개,43271,201,40,200,40,1,7
산화고개,43388,40,231,37,231,3,8
삼덕아파트,37403,710,658,710,658,0,44
삼덕아파트,37404,434,912,434,912,0,43
삼동암리마을회관,43169,0,26,0,26,0,0
삼동암리마을회관,43227,31,3,26,3,5,1
삼두2차아파트,36051,4964,888,4890,888,74,188
삼라마이다스아파트,89317,216,8,213,8,3,7
삼라마이다스아파트,89323,3,101,3,101,0,3
삼목사거리,35088,2,26,2,26,0,0
삼목선착장,35311,248,516,248,516,0,24
삼목선착장(운서역행),35077,1030,260,1030,260,0,41
삼목선착장입구,35058,0,14,0,14,0,0
삼목선착장입구,35059,0,3,0,3,0,0
삼목초등학교,35310,1843,1717,1841,1717,2,114
삼목초등학교,35341,3092,1984,3092,1984,0,163
삼미시장,25915,326,67,326,67,0,12
삼미시장,70172,558,3097,557,3097,1,117
삼미시장,70173,2917,533,2917,533,0,111
삼미타운.e편한세상아파트,40172,5012,5497,4990,5497,22,339
삼보새마을금고,40796,8620,732,8614,732,6,301
삼보아파트,40298,2616,112,2616,112,0,88
삼보아파트,40308,11693,4156,11681,4156,12,511
삼보아파트,40677,7716,400,7714,400,2,261
삼보아파트,40679,417,7309,417,7309,0,249
삼보아파트,40786,4872,17756,4870,17756,2,729
삼보아파트,42350,2774,5244,2772,5244,2,258
삼보아파트,42351,5807,1867,5807,1867,0,247
삼보아파트(계양구청),41205,4139,7661,4126,7661,13,380
삼산경찰서,40584,1110,3142,1108,3142,2,137
삼산경찰서,40766,1742,2993,1742,2993,0,152
삼산고등학교(미래타운3단지),40689,10104,2237,10100,2237,4,398
삼산고등학교(미래타운4단지),40686,4713,7603,4701,7603,12,397
삼산군립어린이집,90171,10,13,9,13,1,0
삼산군립어린이집,90172,29,18,24,18,5,1
삼산글로리병원,40527,7917,6737,7907,6737,10,472
삼산농산물시장,40687,1578,4220,1571,4220,7,187
삼산동차고지,40830,153,3,151,3,2,5
삼산면사무소,90149,24,30,23,30,1,1
삼산면사무소,90150,98,82,95,82,3,5
삼산사거리,40638,5917,11175,5916,11175,1,551
삼산사거리,40690,3272,800,3272,800,0,131
삼산사거리,40691,7935,4717,7935,4717,0,408
삼산사거리,40924,273,2311,273,2311,0,83
삼산사거리(한국아파트),40646,3806,13282,3806,13282,0,551
삼산사거리.한국아파트,40645,6226,1913,6225,1913,1,262
삼산새마을금고,40668,589,8871,589,8871,0,305
삼산서해그랑블,40589,1356,1969,1341,1969,15,107
삼산서해아파트,40613,2696,721,2676,721,20,110
삼산월드체육관,40532,8488,2610,8474,2610,14,358
삼산월드체육관,40535,1300,1229,1295,1229,5,81
삼산월드체육관,40543,66,4265,66,4265,0,139
삼산월드체육관,40571,1620,2214,1615,2214,5,123
삼산월드체육관(삼산주공6단지),40802,885,2003,884,2003,1,93
삼산주공1단지,40780,1835,22,1835,22,0,59
삼산주공1단지(상가앞),40908,6975,511,6975,511,0,241
삼산주공4단지,40591,757,1601,757,1601,0,76
삼산주공7단지,40547,7331,7418,7317,7418,14,475
삼산주공7단지,40801,7389,7864,7377,7864,12,492
삼산중학교,40636,1281,777,1281,777,0,66
삼산중학교,40637,855,1195,855,1195,0,66
삼산체육관역(호수공원),40536,11001,3378,10991,3378,10,463
삼산체육관역(호수공원),40539,503,6618,502,6618,1,229
삼산체육관역.상동호수공원,55040,368,3344,359,3344,9,119
삼산체육관역.상동호수공원,55041,226,600,226,600,0,26
삼산체육관역.영상문화단지정문,55044,12829,3756,12825,3756,4,535
삼산타운1단지,40588,5012,7665,5012,7665,0,408
삼산타운1단지정문,40585,3393,1356,3393,1356,0,153
삼산타운1단지후문,40611,1202,725,1202,725,0,62
삼산타운1단지후문,40612,604,768,604,768,0,44
삼산타운4단지,40608,2412,609,2391,609,21,97
삼산타운6단지,40580,2593,2279,2593,2279,0,157
삼산타운7단지,40576,2330,3000,2330,3000,0,171
삼산푸른솔마을,40653,25,2382,25,2382,0,77
삼선1리마을회관,90263,0,9,0,9,0,0
삼선1리마을회관,90280,12,0,12,0,0,0
삼선1리삼거리,90262,0,4,0,4,0,0
삼선1리삼거리,90281,4,4,4,4,0,0
삼선2리마을회관,90265,5,29,5,29,0,1
삼선2리마을회관,90278,25,7,25,7,0,1
삼선2리입구,90264,1,32,1,32,0,1
삼선2리입구,90279,9,0,9,0,0,0
삼성바이오로직스,39863,9,1270,9,1270,0,41
삼성바이오로직스,39864,5554,43,5554,43,0,180
삼성바이오로직스,39920,2026,2521,2026,2521,0,146
삼성빌라(종점),37572,371,698,371,698,0,34
삼성서초역삼세무서,23396,1009,1316,1009,1316,0,75
삼성아파트,35140,2410,5269,2401,5269,9,247
삼성아파트,38077,5555,5158,5548,5158,7,345
삼성아파트.남인천농협,38125,5845,8164,5832,8164,13,451
삼양감속기,39085,0,7,0,7,0,0
삼양베이커,35131,4,164,4,164,0,5
삼양베이커,35571,84,12,84,12,0,3
삼양사인천1공장,42027,1323,1658,1316,1658,7,96
삼양사인천1공장,42031,3066,4479,3066,4479,0,243
삼영물류,42068,7476,592,7476,592,0,260
삼영아파트,37116,5820,2008,5768,2008,52,252
삼영아파트,37279,10260,10676,10237,10676,23,675
삼영아파트,37280,7335,5050,7308,5050,27,399
삼영아파트,42085,12322,6471,12255,6471,67,606
삼영테크,89055,2006,234,2003,234,3,72
삼영테크,89062,8,1784,8,1784,0,57
삼원페트라,39041,457,3733,457,3733,0,135
삼은교회,37111,4894,1720,4880,1720,14,213
삼익.광명아파트,39247,9872,13011,9858,13011,14,738
삼익.광명아파트,39249,16761,8184,16736,8184,25,804
삼익아파트,35136,2386,6874,2365,6874,21,298
삼익아파트.달동네박물관,36017,9333,11145,9293,11145,40,660
삼일산업,39097,2550,2213,2548,2213,2,153
삼정동중소기업협동화단지,57015,983,1181,983,1181,0,69
삼정동중소기업협동화단지,57040,821,922,821,922,0,56
삼정사거리,57011,661,1055,661,1055,0,55
삼정사거리,57012,815,542,815,542,0,43
삼정초등학교,57008,1012,753,1012,753,0,56
삼정초등학교,57009,525,938,525,938,0,47
삼정프라자,42443,18217,25266,18209,25266,8,1402
삼진금속,39040,2751,356,2751,356,0,100
삼천리1차아파트,41178,2825,2610,2807,2610,18,175
삼천리1차아파트,41179,2904,2276,2862,2276,42,167
삼천리3차아파트,41150,5557,4293,5521,4293,36,317
삼천리3차아파트,41159,5075,5322,5009,5322,66,335
삼천리기계,92017,169,529,169,529,0,22
삼천리기계,92018,273,220,273,220,0,15
삼호제강2공장,39939,142,1023,142,1023,0,37
삼호제강2공장,39940,821,178,821,178,0,32
삼환1단지아파트,37252,1349,2469,1348,2469,1,123
삼환아파트,38063,1675,2883,1669,2883,6,147
삼환아파트,39296,216,1326,209,1326,7,49
삼환아파트,39299,3194,2134,3188,2134,6,171
삼환아파트,39316,11948,8378,11947,8378,1,655
삼환아파트,39323,835,4075,835,4075,0,158
삼환아파트,39328,7610,7494,7610,7494,0,487
삼환아파트,80058,18,1750,18,1750,0,57
상1리마을회관(창말),90339,0,12,0,12,0,0
상1리마을회관(창말),90342,8,0,8,0,0,0
상2리마을회관,90337,0,21,0,21,0,0
상2리마을회관,90343,25,1,25,1,0,0
상덕현삼거리,43462,5,17,5,17,0,0
상덕현삼거리,43767,6,22,6,22,0,0
상도중학교,55025,1782,115,1779,115,3,61
상도중학교,55028,452,1822,451,1822,1,73
상동가구,55090,1636,1510,1617,1510,19,101
상동역1번출구.부천터미널소풍.홈플러스,55052,7071,19087,7050,19087,21,843
상동역4번출구.상동지하차도,55048,1657,6074,1656,6074,1,249
상동역5번출구.상동지하차도,55050,15860,3284,15822,3284,38,617
상동역8번출구세이브존,55056,9521,5197,9503,5197,18,474
상사마을,25027,53,204,53,204,0,8
상수도사업본부(스마트타운),37375,3234,7266,3226,7266,8,338
상수도사업본부(스마트타운),37380,4564,9275,4540,9275,24,446
상야동,41436,1307,1091,1307,1091,0,77
상야동,41437,1016,1499,1014,1499,2,81
상용리마을회관,90038,0,41,0,41,0,1
상용리마을회관,90039,52,3,52,3,0,1
상용진료소앞,90004,13,77,10,77,3,2
상용진료소앞,90005,69,11,69,11,0,2
상인천중학교,39537,241,103,241,103,0,11
상인천초등학교,39340,765,456,752,456,13,39
상인천초등학교,39345,363,907,362,907,1,40
상정고,40069,11052,3112,11050,3112,2,456
상정고,40070,4030,11900,4028,11900,2,513
상정중학교,40059,3949,7535,3945,7535,4,370
상주(상리),90331,13,5,12,5,1,0
상주민지원센터.삼광교회,55029,1082,4261,1073,4261,9,172
상주민지원센터.삼광교회,55031,5892,500,5874,500,18,206
상촌,43152,32,7,31,7,1,1
상촌,43347,19,51,19,51,0,2
새꾸지마을,90133,33,19,33,19,0,1
새꾸지마을,90134,41,35,39,35,2,2
새마을,43471,2,12,2,12,0,0
새마을,43702,10,4,10,4,0,0
새마을금고,36053,2569,960,2555,960,14,113
새마을금고,36189,354,1612,345,1612,9,63
새마을금고,40125,848,1321,848,1321,0,69
새마을금고,40126,2006,273,2006,273,0,73
새마을금고,40131,955,3621,947,3621,8,147
새마을금고,40746,81,843,81,843,0,29
새말사거리,41009,4233,2447,4232,2447,1,215
새말사거리,41010,127,3195,126,3195,1,107
새말사거리,41012,1266,3033,1260,3033,6,138
새말사거리,41013,3250,2410,3242,2410,8,182
새말사거리,41638,1027,1971,1026,1971,1,96
새봄초등학교,38679,2457,4593,2445,4593,12,227
새봄초등학교·송도파크레인(후문),38678,5389,1862,5371,1862,18,233
새사미아파트,41582,503,335,503,335,0,27
새소망교회,40850,1968,8,1947,8,21,63
새소망교회,40917,1,415,1,415,0,13
새안의원,37255,10166,12487,10130,12487,36,730
새안의원,37256,17642,8769,17596,8769,46,851
새터마을,35033,10,222,10,222,0,7
새터마을,35362,268,30,267,30,1,9
새한아파트,37046,4821,2531,4797,2531,24,237
색동원 앞,43161,7,3,7,3,0,0
색동원 앞,43215,8,10,8,10,0,0
샘골,90406,0,4,0,4,0,0
샘골,90407,5,0,5,0,0,0
샘내들교,89518,1,36,1,36,0,1
샘내들교,89519,4,112,4,112,0,3
샘말,43444,7,8,7,8,0,0
샘말,43782,41,11,32,11,9,1
샛말,43994,15,12,15,12,0,0
샛말,43995,20,31,20,31,0,1
생산기술연구원,38354,161,797,161,797,0,30
생설미,43746,465,245,453,245,12,22
생설미입구,43125,5,4,5,4,0,0
생설미입구,43607,7,5,7,5,0,0
생설미입구,43608,0,70,0,70,0,2
샬롬원입구,90293,11,15,11,15,0,0
샬롬원입구,90297,3,1,3,1,0,0
서곶지구대,42338,9527,7993,9526,7993,1,565
서곶지구대,42339,10929,7677,10929,7677,0,600
서교동,23037,185,4399,185,4399,0,147
서교동,23038,10869,193,10869,193,0,356
서구국민체육센터,42776,666,3601,665,3601,1,137
서구문화회관,42212,1419,1861,1406,1861,13,105
서구문화회관,42213,2846,835,2808,835,38,118
서구보건소,42283,4552,3833,4544,3833,8,270
서구보건소,42285,3634,4315,3634,4315,0,256
서구영어마을,42448,6942,4804,6936,4804,6,378
서구영어마을,42449,3858,8003,3847,8003,11,382
서구청역(1번출구),42289,4047,3639,4041,3639,6,247
서구청역(3번출구),42284,1267,749,1266,749,1,65
서구청역(4번출구),42296,1908,2503,1900,2503,8,142
서남촌,43151,10,4,9,4,1,0
서남촌,43640,2,8,2,8,0,0
서당골,35676,38,66,38,66,0,3
서당골,35702,97,39,97,39,0,4
서두머리,43212,27,1,27,1,0,0
서두머리,43336,0,14,0,14,0,0
서림초등학교,36036,5,557,5,557,0,18
서림초등학교,36047,9601,1004,9598,1004,3,342
서릿목,35418,175,492,175,492,0,21
서릿목,35419,602,150,597,150,5,24
서면초등학교,38384,1571,1513,1558,1513,13,99
서문안,43385,28,133,28,133,0,5
서문안,43584,145,15,124,15,21,5
서문안주유소,43965,145,14,139,14,6,5
서문안주유소,43966,19,184,19,184,0,6
서부경찰서,42286,530,772,530,772,0,42
서부공단입구,42299,4967,5378,4966,5378,1,333
서부공단입구,42301,6041,1421,6038,1421,3,240
서부산업단지,89035,62,62,62,62,0,4
서부산업단지,89036,42,301,42,301,0,11
서사체험학습장,43487,7,4,7,4,0,0
서사체험학습장,43712,16,7,16,7,0,0
서성,43234,5,89,5,89,0,3
서성,43362,230,5,226,5,4,7
서운교,41114,725,3896,714,3896,11,149
서운교,41115,4038,363,4035,363,3,141
서운도서관,41099,1606,239,1606,239,0,59
서운도서관,41102,165,1926,165,1926,0,67
서운도서관,41668,62,1838,62,1838,0,61
서운동,41356,5588,313,5558,313,30,190
서운동성당,41207,1416,1977,1404,1977,12,109
서운일반산업단지,41660,2533,15,2507,15,26,82
서운일반산업단지(맞은편),41661,99,1820,86,1820,13,61
서운일반산업단지입구,41646,674,3916,671,3916,3,148
서운일반산업단지입구(맞은편),41647,1156,1324,1150,1324,6,80
서운중고등학교,41109,271,606,271,606,0,28
서운중고등학교,41111,410,465,409,465,1,28
서울경금속,39039,195,2827,194,2827,1,97
서울방화초등학교,25028,79,10,79,10,0,2
서울역,11013,13767,11411,13767,11411,0,812
서원아파트,37095,1616,1196,1601,1196,15,90
서인천가구단지,42017,1048,3488,1048,3488,0,146
서인천가구단지,42028,3663,2760,3643,2760,20,207
서인천가구단지,42800,655,87,655,87,0,23
서인천고등학교,42346,4147,3639,4147,3639,0,251
서인천농협,42275,1515,564,1515,564,0,67
서인천농협,42277,264,891,264,891,0,37
서인천세무서,89044,282,98,279,98,3,12
서인천세무서,89481,185,130,185,130,0,10
서인천세무서(중),89275,2436,2686,2436,2686,0,165
서인천세무서(중),89276,1166,2490,1166,2490,0,117
서인천자동차검사소,42640,585,3367,585,3367,0,127
서인천자동차검사소,42641,4640,359,4640,359,0,161
서창119안전센터,39900,9538,3272,9538,3272,0,413
서창119안전센터,39899,5198,9195,5198,9195,0,464
서창LH1단지아파트,92067,5249,343,5249,343,0,180
서창LH1단지아파트,92068,887,4026,887,4026,0,158
서창공영차고지,39871,8259,116,8227,116,32,270
서창공영차고지,39872,1957,5572,1893,5572,64,242
서창도서관,39893,1242,1831,1241,1831,1,99
서창도서관,39894,1936,1069,1936,1069,0,96
서창도서관입구,39956,123,1519,123,1519,0,52
서창도서관입구,39957,2782,766,2782,766,0,114
서창동화원,39619,163,844,163,844,0,32
서창동화원,39620,454,348,452,348,2,25
서창베라체아파트후문,39895,325,119,325,119,0,14
서창베라체아파트후문,39896,20,457,20,457,0,15
서창센트라스아파트후문,39916,6469,728,6467,728,2,232
서창센트라스아파트후문,39917,1123,4000,1119,4000,4,165
서창센트럴푸르지오,39811,3378,335,3374,335,4,119
서창센트럴푸르지오,39812,371,3006,370,3006,1,108
서창센트럴푸르지오,39903,12747,7225,12725,7225,22,644
서창센트럴푸르지오,39904,12448,11922,12446,11922,2,786
서창이편한세상1002동,39905,12944,7871,12915,7871,29,671
서창이편한세상1002동,39906,7380,13400,7380,13400,0,670
서창이편한세상정문,39854,722,13589,720,13589,2,461
서창이편한세상정문,39855,14285,571,14267,571,18,479
서창퍼스트뷰후문,39777,11691,2797,11691,2797,0,467
서창퍼스트뷰후문맞은편,39778,1567,9974,1567,9974,0,372
서창휴먼시아12단지,39897,2102,149,2102,149,0,72
서창휴먼시아12단지,39898,304,1495,304,1495,0,58
서초구청,22129,470,47,470,47,0,16
서초동삼성아파트,22140,27,181,27,181,0,6
서초아트자이아파트,31050,4129,10963,4129,10963,0,486
서초역1번출구,31007,9004,23472,9004,23472,0,1047
서초힐스아파트,22286,653,1481,653,1481,0,68
서한리구마을회관,90294,20,8,20,8,0,0
서한리구마을회관,90296,2,0,2,0,0,0
서한리마을회관,90295,47,27,47,27,0,2
서해5도특별경비단,35098,1391,144,1371,144,20,49
서해5도특별경비단,35884,40,1271,39,1271,1,42
서해그랑블,40828,2420,163,2420,163,0,83
서해그랑블,42789,2502,7663,2502,7663,0,327
서해그랑블,42790,5339,1956,5338,1956,1,235
서해그랑블,42912,3714,867,3704,867,10,147
서해그랑블1단지아파트,38604,1004,34,1004,34,0,33
서해그랑블1단지아파트,38605,51,736,49,736,2,25
서해그랑블3단지아파트,38725,837,34,836,34,1,28
서해그랑블3단지아파트,38726,25,700,25,700,0,23
서해그랑블아파트후문,39973,1783,2026,1779,2026,4,122
서해그랑블아파트후문,39974,2750,2582,2750,2582,0,172
서해그랑블후문,40610,100,1066,100,1066,0,37
서해수산연구소,35007,131,5,128,5,3,4
서해수산연구소,35008,10,268,10,268,0,8
서해아파트,38164,2859,1386,2859,1386,0,136
서해아파트,38169,2296,2263,2296,2263,0,147
서해아파트,41181,1321,2153,1318,2153,3,112
서해아파트,41182,2600,1271,2588,1271,12,124
서해아파트,42354,4069,10366,4069,10366,0,465
서해아파트,42355,16655,3897,16654,3897,1,662
서홍의입구,43446,1,17,1,17,0,0
서홍의입구,43796,48,7,48,7,0,1
서화초등학교(도화e편한세상),37438,12533,6586,12513,6586,20,616
서화초등학교(도화e편한세상),37623,8677,10129,8666,10129,11,606
서흥초등학교,36071,7491,3307,7464,3307,27,348
서흥초등학교,36116,611,411,610,411,1,32
서흥초등학교,36117,194,2080,194,2080,0,73
석건연립,37051,1793,7447,1787,7447,6,298
석남고가교입구사거리,42655,22696,8559,22689,8559,7,1008
석남고가사거리,42145,20034,17086,19958,17086,76,1197
석남고가사거리,42151,28518,20455,28483,20455,35,1579
석남금호어울림아파트101동,42656,4575,9431,4572,9431,3,451
석남도서관,42182,862,1897,858,1897,4,89
석남동차고지,89156,616,0,616,0,0,19
석남서초등학교,42108,5598,3093,5593,3093,5,280
석남신사거리,42149,2042,1545,2018,1545,24,115
석남신사거리,42150,2005,2760,1994,2760,11,153
석남역(5번출구),42577,21833,43792,21806,43792,27,2116
석남중앙교회,42138,3147,1940,3128,1940,19,164
석남중학교,42126,7396,5146,7358,5146,38,404
석남중학교,42128,5332,6683,5288,6683,44,387
석남초등학교,42165,9591,3162,9498,3162,93,411
석남초등학교,42167,2939,7419,2918,7419,21,334
석락아파트,37241,10250,8493,10192,8493,58,604
석락아파트,37244,1967,3802,1960,3802,7,186
석모1리마을회관,90145,47,16,46,16,1,2
석모1리마을회관,90146,5,13,5,13,0,0
석모대교(석모리방향),90137,2,14,2,14,0,0
석모대교(석모리방향),90138,29,8,27,8,2,1
석모대교(석포리방향),90139,19,1,19,1,0,0
석모대교(석포리방향),90140,33,87,33,87,0,3
석모대교(외포리방향),90121,1,37,1,37,0,1
석모대교(외포리방향),90122,18,2,18,2,0,0
석모대교전망대,90249,2,2,2,2,0,0
석모대교전망대,90250,4,8,4,8,0,0
석모도미네랄온천,90163,73,26,70,26,3,3
석모도미네랄온천,90164,13,40,13,40,0,1
석모도수목원입구(삼산초등학교),90143,3,32,3,32,0,1
석모도수목원입구(삼산초등학교),90144,55,40,50,40,5,3
석모도자연휴양림입구,90151,0,15,0,15,0,0
석모도자연휴양림입구,90152,18,4,18,4,0,0
석바위,37365,21811,18734,21739,18734,72,1307
석바위,37370,51374,39173,51302,39173,72,2920
석바위시장,37378,2470,6144,2455,6144,15,277
석바위시장,37381,24599,24589,24538,24589,61,1586
석바위시장,37382,21698,19173,21650,19173,48,1318
석바위시장,37384,5018,3833,5002,3833,16,285
석바위시장,37544,3134,4340,3111,4340,23,241
석바위시장역,37373,4650,5360,4632,5360,18,322
석바위시장역,37374,3838,4670,3821,4670,17,274
석산,43375,1,36,1,36,0,1
석산,43833,34,1,34,1,0,1
석산로,92051,944,405,916,405,28,43
석산로,92052,376,506,369,506,7,28
석암초등학교,37412,3736,3945,3722,3945,14,247
석암초등학교앞,37407,13596,8006,13529,8006,67,696
석정여자고등학교,39416,1460,240,1434,240,26,54
석정여자고등학교,39418,112,1592,110,1592,2,54
석조여래입상앞,43663,0,29,0,29,0,0
석조여래입상앞,43692,47,1,44,1,3,1
석천사거리,39308,605,799,596,799,9,45
석천사거리역,39317,3815,6830,3812,6830,3,343
석천사거리역,39320,2591,3009,2581,3009,10,180
석천시장,39502,821,4058,818,4058,3,157
석포리마을회관,90191,22,4,22,4,0,0
석포리마을회관,90192,8,23,8,23,0,1
석포항,90203,21,36,20,36,1,1
선경그린빌라,42307,2358,1513,2356,1513,2,124
선경그린빌라,42541,94,740,94,740,0,26
선경아파트,40238,7570,1737,7570,1737,0,300
선광,38542,2,347,2,347,0,11
선광,38543,243,9,243,9,0,8
선녀바위유원지,35004,672,22,663,22,9,22
선녀바위유원지,35006,103,588,103,588,0,22
선녀바위해수욕장,35484,1018,154,1018,154,0,37
선녀바위해수욕장,35485,266,706,265,706,1,31
선동,43248,0,15,0,15,0,0
선동,43886,47,0,45,0,2,1
선두1리,43009,310,110,309,110,1,13
선두1리,43099,94,169,94,169,0,8
선두4리마을회관,43242,18,7,18,7,0,0
선두4리마을회관,43644,2,12,2,12,0,0
선두5리어판장입구,90131,7,29,6,29,1,1
선두5리어판장입구,90132,26,4,26,4,0,0
선릉역,23218,2627,6,2627,6,0,84
선릉역,23259,95,4174,95,4174,0,137
선린감리교회,40043,3435,2126,3434,2126,1,179
선린감리교회,40047,4597,5787,4586,5787,11,334
선바위역,66001,17350,689,17350,689,0,581
선바위역,66002,1231,32347,1231,32347,0,1083
선수,43433,2,19,2,19,0,0
선수,43483,33,9,33,9,0,1
선수여객선착장,43429,171,105,152,105,19,8
선수여객선착장,43479,14,61,14,61,0,2
선수촌사거리,39889,208,613,202,613,6,26
선수촌사거리,39890,371,273,363,273,8,20
선원면사무소앞,90067,0,40,0,40,0,1
선원면사무소앞,90068,11,12,11,12,0,0
선원면주민센터,43042,168,471,168,471,0,20
선원면주민센터,43070,538,149,534,149,4,22
선원사,43305,0,1,0,1,0,0
선원사,43742,21,13,18,13,3,1
선원사초입,43307,16,7,15,7,1,0
선원사초입,43756,7,4,7,4,0,0
선원초등학교,43044,63,180,63,180,0,7
선원초등학교,43045,173,56,168,56,5,7
선유고등학교,28017,10257,676,10257,676,0,352
선유고등학교,28018,724,11582,724,11582,0,396
선재대교,44085,6,0,5,0,1,0
선재대교,44175,3,0,3,0,0,0
선재대교입구,44005,31,481,29,481,2,16
선재대교입구,44006,600,33,593,33,7,20
선재바다낚시터,44176,0,1,0,1,0,0
선주삼거리,41481,18,95,18,95,0,3
선주삼거리,41502,2,0,2,0,0,0
선주지교회,41482,20,43,20,43,0,2
선주지교회,41503,9,1,9,1,0,0
선주지다리,41480,0,26,0,26,0,0
선주지다리,41501,1,2,1,2,0,0
선주지회차지,41483,18,23,18,23,0,1
선학동행정복지센터.정광아파트,38297,1354,1133,1353,1133,1,80
선학사거리,38295,1042,3862,1041,3862,1,158
선학아파트,38232,6419,1766,6419,1766,0,264
선학아파트,38343,3212,10200,3205,10200,7,432
선학어린이집,38300,2040,1994,2009,1994,31,130
선학역,38305,31277,14770,31234,14770,43,1485
선학역(1번출구),38306,19480,23005,19430,23005,50,1370
선학중학교,38283,863,930,820,930,43,57
선학체육관(하키경기장),38308,3200,2061,3190,2061,10,169
선학체육관(하키경기장),38309,2585,4204,2582,4204,3,219
선행리입구,43908,206,223,205,223,1,13
선행리입구,43909,35,3,35,3,0,1
설호아파트,43378,19,91,19,91,0,3
설호아파트,43618,120,49,117,49,3,5
성강지식산업센터,39837,621,789,621,789,0,45
성경,43603,157,7,157,7,0,5
성경,43771,9,143,9,143,0,4
성리중학교,39969,42,14,42,14,0,1
성리중학교,39979,3,196,3,196,0,6
성리초등학교,39200,20516,19651,20455,19651,61,1295
성리초등학교,39201,9191,15613,9163,15613,28,800
성문교회,39462,515,7,513,7,2,16
성문아파트,39591,4085,1380,4064,1380,21,176
성문아파트(문화연립),39257,2794,3744,2773,3744,21,210
성민병원,42159,14684,14359,14576,14359,108,936
성민병원,42162,13980,16902,13925,16902,55,996
성보공업,42007,2083,2168,2072,2168,11,137
성산교회,40572,1651,7375,1624,7375,27,291
성신아크릴산업,89313,143,0,142,0,1,4
성신아크릴산업,89327,9,173,9,173,0,5
성웅아파트,42048,3659,2884,3653,2884,6,211
성웅아파트,42051,4208,2704,4199,2704,9,222
성원기계,92016,1598,1828,1598,1828,0,110
성원빌딩.우편취급국,37425,10817,6009,10804,6009,13,542
성원아파트,70022,2340,11,2332,11,8,75
성일산업,39787,988,1714,986,1714,2,87
성일산업,39788,1080,813,1078,813,2,61
성일아파트후문앞,40311,813,523,813,523,0,43
성지아파트,38017,23240,35967,23233,35967,7,1909
성지아파트,41025,5390,3223,5390,3223,0,277
성지초등학교,41033,1863,3354,1847,3354,16,168
성지초등학교,41034,2441,1751,2425,1751,16,135
성터지,43038,241,61,240,61,1,9
성터지,43039,40,217,40,217,0,8
성호아파트,38204,10822,9662,10792,9662,30,660
세광2차아파트,43758,2114,613,2075,613,39,87
세광2차아파트,43857,441,1295,427,1295,14,56
세광아파트,43049,1067,1998,1060,1998,7,98
세광아파트,43050,2967,802,2938,802,29,121
세농푸드,41510,31,0,31,0,0,1
세우산업,39094,2028,4547,2028,4547,0,212
세월천사거리,40489,4343,13943,4308,13943,35,589
세일빌라.인천산림조합,39158,2292,1051,2284,1051,8,107
세일빌라.인천산림조합,39159,4607,3472,4598,3472,9,260
세현정공,39033,942,2001,942,2001,0,94
세화파렛텍,90216,37,39,37,39,0,2
센타빌딩,39902,10749,13158,10746,13158,3,771
센트럴공원,38490,726,3061,724,3061,2,122
센트럴자이,39884,4056,2585,4054,2585,2,214
센트럴파크1,38463,542,138,542,138,0,21
센트럴파크2,38464,273,347,273,347,0,20
센트럴파크역,38397,8442,1122,8442,1122,0,308
센트럴파크역,38574,792,2545,790,2545,2,107
센트럴파크푸르지오아파트,38544,1799,1023,1798,1023,1,91
센트럴파크푸르지오아파트,38545,866,1730,865,1730,1,83
센트럴푸르지오501동앞,92071,1405,397,1402,397,3,58
셀트리온(주),38319,167,492,167,492,0,21
셀트리온(주)앞,38513,446,330,445,330,1,25
셀트리온2공장앞,38474,438,705,438,705,0,36
셀트리온2공장앞,38475,1111,352,1111,352,0,47
소게,43185,1,103,1,103,0,3
소게,43243,82,1,80,1,2,2
소구월사거리,39266,5068,11325,5039,11325,29,528
소구월사거리,39268,4536,3381,4502,3381,34,255
소나무,43396,55,0,54,0,1,1
소나무,43805,0,37,0,37,0,1
소담(장미)마을입구,90236,0,7,0,7,0,0
소담(장미)마을입구,90237,5,0,5,0,0,0
소동,43412,127,1,127,1,0,4
소동,43829,11,149,11,149,0,5
소똑골 입구,90424,0,5,0,5,0,0
소똑골 입구,90425,1,0,1,0,0,0
소래도서관,39829,21,473,3,473,18,15
소래산등산로입구,39770,0,24,0,24,0,0
소래산등산로입구,39771,10,5,10,5,0,0
소래산입구,39668,12,300,12,300,0,10
소래산입구,39670,420,0,420,0,0,13
소래역사관,39816,135,1348,135,1348,0,47
소래역사관,39817,2167,110,2158,110,9,73
소래초등학교,39615,244,362,244,362,0,19
소래포구,39815,740,58,737,58,3,25
소래포구,39818,72,2065,71,2065,1,68
소래포구 해오름광장,92074,65,1034,61,1034,4,35
소래포구역,39647,3229,1438,3229,1438,0,150
소래포구역,39648,2312,4976,2309,4976,3,235
소래포구역,39710,1610,46,1599,46,11,53
소래포구역앞,92063,2161,1083,2161,1083,0,104
소래포구역종점,39793,516,50,506,50,10,18
소래포구입구,70009,752,164,743,164,9,29
소래포구입구(논현푸르지오A),39109,352,863,351,863,1,39
소래포구입구(논현푸르지오A),39114,259,174,258,174,1,13
소래풍림아파트,39122,2650,701,2646,701,4,108
소리공원(하모니로),38721,423,794,423,794,0,39
소리공원(하모니로),38722,263,336,263,336,0,19
소망탑빌라,40116,7,305,7,305,0,10
소방대앞,90022,9,113,9,113,0,3
소방대앞,90023,256,22,249,22,7,8
소산서원,70011,198,667,196,667,2,27
소산서원,70012,246,356,244,356,2,19
소장전,43996,18,17,18,17,0,1
소장전,43997,6,5,6,5,0,0
소촌마을,41662,125,11,124,11,1,4
속아지,43344,33,0,31,0,2,1
속아지,43848,0,27,0,27,0,0
솔밭마을,38193,936,275,935,275,1,39
솔빛마을,36034,8466,9218,8438,9218,28,570
솔빛마을,36037,5709,6241,5688,6241,21,385
솔빛마을주공아파트,36049,10245,6610,10222,6610,23,543
솔빛마을주공아파트,36050,9302,11865,9283,11865,19,682
솔빛주공2단지,36045,894,770,882,770,12,53
솔안공원,38348,10274,6852,10267,6852,7,552
솔정,43526,27,0,18,0,9,0
솔정,43871,6,16,3,16,3,0
솔정1리마을회관,90085,1,7,1,7,0,0
솔정1리마을회관,90086,1,0,0,0,1,0
솔정마을,43129,62,5,55,5,7,2
솔정마을,43811,10,1,10,1,0,0
솔정마을,43872,29,49,21,49,8,2
솔정마을,90108,0,5,0,5,0,0
솔정정미소,43130,17,28,17,28,0,1
솔정정미소,43134,34,6,33,6,1,1
솔터마을입구,80327,981,300,980,300,1,41
솔터마을입구,80336,1128,1135,1128,1135,0,73
솔펜션,44177,8,0,6,0,2,0
송곡촌,43439,28,42,28,42,0,2
송곡촌,43815,66,29,65,29,1,3
송내고교입구,11014,78,330,78,330,0,13
송내고교입구,11015,539,160,539,160,0,22
송내고등학교,40219,2124,2701,2110,2701,14,155
송내남부역,40761,34,1323,34,1323,0,43
송내역.로데오거리,55267,5385,26004,5372,26004,13,1012
송내역.영화의거리,55263,23087,6943,23033,6943,54,968
송내역남부,56002,84628,67677,84580,67677,48,4913
송내역남부,56005,97821,80042,97690,80042,131,5737
송담초등학교,38667,2117,788,2117,788,0,93
송담초등학교,38668,765,1993,765,1993,0,88
송도1동행정복지센터,38012,4681,12213,4674,12213,7,544
송도2동행정복지센터,38492,4590,3087,4588,3087,2,247
송도2동행정복지센터,38588,1101,1566,1101,1566,0,86
송도MTB파크,38746,204,220,204,220,0,13
송도SK뷰(101동),38635,1959,358,1959,358,0,74
송도SK뷰(105동),38632,81,609,81,609,0,22
송도SK뷰(105동),38633,1088,130,1088,130,0,39
송도sk뷰,38707,782,3655,779,3655,3,143
송도sk뷰,38708,677,1376,674,1376,3,66
송도고입구,38215,1163,1858,1156,1858,7,97
송도고입구,38221,1106,617,1100,617,6,55
송도공영차고지,38472,411,35,411,35,0,14
송도국제교입구,38597,214,1,214,1,0,6
송도국제도시디에트르시그니처뷰,38771,2308,1363,2307,1363,1,118
송도글로벌캠퍼스푸르지오아파트,38711,758,795,758,795,0,50
송도누리공원,38663,4206,4684,4206,4684,0,286
송도누리공원,38664,986,3565,983,3565,3,146
송도달빛축제공원,38776,124,330,124,330,0,14
송도달빛축제공원역,38696,19482,3264,19472,3264,10,733
송도달빛축제공원역,38697,2745,16474,2743,16474,2,619
송도더샵그린스퀘어,39843,3455,1357,3454,1357,1,155
송도더샵그린워크,38526,1092,388,1092,388,0,47
송도더샵그린워크2차,38493,2227,2740,2227,2740,0,160
송도더샵마스터뷰21단지,38578,5788,959,5761,959,27,217
송도더샵마스터뷰22단지,38693,550,200,550,200,0,24
송도더샵마스터뷰22단지(2202동),38698,177,421,177,421,0,19
송도더샵마스터뷰22단지(2202동),38712,369,1148,369,1148,0,48
송도더샵마스터뷰22단지(정문),38694,222,994,222,994,0,39
송도더샵마스터뷰22단지(하행),38695,202,576,202,576,0,25
송도더샵마스터뷰23단지,38441,2980,1949,2977,1949,3,159
송도더샵마스터뷰23단지,38442,377,3929,375,3929,2,138
송도더샵마스터뷰23단지(정문),38692,1484,233,1484,233,0,55
송도더샵센트럴시티,39842,2251,3096,2236,3096,15,172
송도더샵센트럴시티.글로벌캠퍼스푸르지오,38647,5608,1213,5608,1213,0,220
송도더샵퍼스트월드,38589,1158,1467,1158,1467,0,84
송도더샵퍼스트월드(동문),38013,16923,6450,16912,6450,11,753
송도더샵퍼스트월드(서문),38381,3245,1390,3230,1390,15,149
송도더샵퍼스트월드B동.C동,38425,3965,2257,3962,2257,3,200
송도더샵퍼스트월드D동,38009,1748,1697,1747,1697,1,111
송도더샵퍼스트파크14단지,38560,489,3711,484,3711,5,135
송도더샵퍼스트파크14단지,38577,3065,365,3054,365,11,110
송도더샵퍼스트파크15단지,38559,245,999,242,999,3,40
송도더샵퍼스트파크15단지,38576,1016,208,1000,208,16,39
송도더샵하버뷰2차,38467,2387,13087,2386,13087,1,499
송도동일하이빌파크포레아파트,38680,3115,1132,3090,1132,25,137
송도라마다호텔앞,38065,2197,4287,2185,4287,12,209
송도라마다호텔앞,38067,11414,7920,11373,7920,41,623
송도랜드마크시티13호근린공원,38738,425,2127,425,2127,0,82
송도랜드마크시티13호근린공원,38739,1394,428,1394,428,0,58
송도랜드마크푸르지오시티,38747,909,1631,907,1631,2,81
송도베르디움더퍼스트후문,39985,1284,4688,1284,4688,0,192
송도세브란스병원,38651,22,586,22,586,0,19
송도센트럴파크,38452,2430,6223,2430,6223,0,279
송도센트럴파크역,38563,2253,806,2237,806,16,98
송도소방서(송도스마트밸리),39801,1960,2931,1960,2931,0,157
송도스마트밸리,39802,4494,1719,4494,1719,0,200
송도스포츠센터(LNG야구장),39721,1356,885,1356,885,0,72
송도아트윈푸르지오,38549,326,563,322,563,4,28
송도아트윈푸르지오,38562,7,313,4,313,3,10
송도에듀포레푸르지오,39921,1289,2952,1289,2952,0,136
송도에듀포레푸르지오후문,39986,5188,737,5188,737,0,191
송도역,38213,2285,1749,2283,1749,2,130
송도역,38505,7804,15241,7800,15241,4,743
송도역,38669,915,1447,915,1447,0,76
송도영남아파트,38224,7705,6380,7697,6380,8,454
송도오션파크베르디움,38642,1360,17511,1355,17511,5,608
송도요양원,38144,1772,2524,1772,2524,0,138
송도유원지(도로교통공단),38081,10535,11993,10492,11993,43,726
송도유원지(도로교통공단),38088,18802,6890,18731,6890,71,828
송도자이하버뷰,38521,3061,1984,3061,1984,0,162
송도자이하버뷰1단지,38468,17002,2112,17000,2112,2,616
송도자이하버뷰2단지(202동),38488,1606,3108,1603,3108,3,152
송도자이하버뷰2단지(205동),38455,481,372,481,372,0,27
송도자이하버뷰2단지(정문),38465,2558,1601,2550,1601,8,134
송도자이하버뷰2단지(정문),38498,1753,1618,1752,1618,1,108
송도재래시장,38207,6045,7155,6038,7155,7,425
송도재래시장,38210,8278,7535,8263,7535,15,510
송도재래시장,38220,5893,2156,5877,2156,16,259
송도제2차고지,38703,424,16,406,16,18,14
송도제2차고지입구,38735,237,606,235,606,2,27
송도중학교,35155,9922,11294,9868,11294,54,684
송도지웰푸르지오시티,38424,4544,10705,4543,10705,1,491
송도채석장,38175,687,2180,687,2180,0,92
송도체육센터,38699,136,701,136,701,0,27
송도체육센터,38700,767,207,766,207,1,31
송도컨벤시아,38367,1841,6376,1836,6376,5,265
송도컨벤시아,38369,2643,1413,2637,1413,6,130
송도컨벤시아남문,38660,2214,1223,2214,1223,0,110
송도컨벤시아남문,38661,1210,2247,1210,2247,0,111
송도타임스페이스,38720,1702,3117,1702,3117,0,155
송도테크노파크IT센터,38752,20,1078,20,1078,0,35
송도테크노파크IT센터,39929,3141,2415,3141,2415,0,179
송도파크레인동일하이빌,38625,8,68,8,68,0,2
송도파크레인동일하이빌,38626,695,6,695,6,0,22
송도파크레인입구,38538,548,3013,546,3013,2,114
송도파크레인입구,38539,1239,1335,1239,1335,0,83
송도파크자이,38627,660,496,657,496,3,37
송도파크자이,38628,1,440,1,440,0,14
송도파크자이아파트,38638,9061,8022,9048,8022,13,551
송도파크자이아파트정문,38677,1155,5083,1153,5083,2,201
송도푸르지오월드마크,38426,5248,6830,5244,6830,4,389
송도푸르지오하버뷰,38494,2981,4056,2981,4056,0,227
송도풍림아이원1단지,38033,2938,25043,2928,25043,10,902
송도풍림아이원2단지,38025,10392,15888,10353,15888,39,847
송도풍림아이원2단지,38026,10337,5251,10323,5251,14,502
송도풍림아이원2단지,38034,26908,2710,26859,2710,49,955
송도풍림아이원4단지,38032,3563,9176,3555,9176,8,410
송도힐스테이트,38479,17948,6624,17944,6624,4,792
송도힐스테이트5단지,38393,6128,7372,6127,7372,1,435
송도힐스테이트6단지,38554,14,75,14,75,0,2
송동마을.서초힐스아파트,22962,1252,94,1252,94,0,43
송림119안전센터,36165,93,273,93,273,0,11
송림3.5동행정복지센터(재능대),36030,1376,3159,1375,3159,1,146
송림4동행정복지센터,36127,1460,1449,1458,1449,2,93
송림고가교,37491,2299,1279,2296,1279,3,115
송림고가교,37492,1289,2278,1283,2278,6,115
송림고개(도화신동아아파트),37439,7586,8285,7560,8285,26,511
송림고개(도화신동아아파트),37501,10529,6735,10501,6735,28,556
송림동진로아파트,36154,302,276,302,276,0,18
송림동진로아파트,36155,125,703,121,703,4,26
송림빌라,43316,30,0,30,0,0,0
송림빌라,43775,0,38,0,38,0,1
송림시장,36015,231,340,231,340,0,18
송림오거리,36131,13859,3733,13841,3733,18,567
송림오거리,36132,3577,9036,3567,9036,10,406
송림주유소,36090,639,517,635,517,4,37
송림체육관,36130,669,66,669,66,0,23
송림체육관,36148,34,351,34,351,0,12
송림체육관후문,36152,398,774,398,774,0,37
송림체육관후문,36153,761,549,761,549,0,42
송림휴먼시아,36124,21,723,21,723,0,24
송림휴먼시아,36125,44,1337,44,1337,0,44
송마3리,80157,918,28,917,28,1,30
송마3리,80158,31,384,31,384,0,13
송마리입구,80159,46,673,45,673,1,23
송마리입구,80160,358,149,355,149,3,16
송명초등학교,92013,3644,338,3644,338,0,128
송산,43482,56,20,54,20,2,2
송산,43710,41,81,40,81,1,3
송산교회,43956,18,24,18,24,0,1
송산삼거리,43480,35,1,32,1,3,1
송산삼거리,43611,2,49,2,49,0,1
송암박두성생가입구,90396,0,16,0,16,0,0
송암박두성생가입구,90397,16,0,15,0,1,0
송월동동화마을,35189,5835,2971,5781,2971,54,284
송월동동화마을,35190,2703,7873,2695,7873,8,341
송월아파트,35193,2678,543,2661,543,17,103
송월아파트,35194,856,3015,853,3015,3,124
송정역,25184,65,3780,65,3780,0,124
송정역,25185,5626,68,5616,68,10,183
송학둥지아파트,38584,1734,2896,1722,2896,12,149
송학둥지아파트,38585,1082,2042,1072,2042,10,100
송해교회,43384,298,93,296,93,2,12
송해교회,43769,56,339,56,339,0,12
송해면사무소,43708,45,142,43,142,2,6
송해면사무소,43809,74,55,74,55,0,4
송해삼거리,43386,407,69,396,69,11,15
송해삼거리,43819,108,442,107,442,1,17
송해초등학교,43807,34,136,34,136,0,5
송해초등학교,43820,116,29,114,29,2,4
송현시장.수도국산달동네박물관,36019,7869,5578,7821,5578,48,433
송현시장.수도국산달동네박물관,36020,5968,22099,5935,22099,33,905
송현시장.수도국산달동네박물관,36025,48,549,42,549,6,19
송현아파트,36065,5468,3267,5451,3267,17,281
송현아파트,36067,1850,3947,1850,3947,0,187
송현주공아파트,36073,771,2616,771,2616,0,109
송현주공아파트,36080,10788,5431,10759,5431,29,523
송현주공아파트후문,36162,650,3073,650,3073,0,120
쇠골큰말,89318,86,48,86,48,0,4
쇠골큰말,89321,80,18,76,18,4,3
수곡(월곳리),43191,33,0,33,0,0,1
수곡(월곳리),43620,0,28,0,28,0,0
수광티티아이,90215,15,8,15,8,0,0
수도군수지원단(장애인복지관),40825,5294,1540,5277,1540,17,220
수도군수지원단(장애인복지관),40826,11,1369,10,1369,1,44
수림공원,39347,1601,693,1601,693,0,74
수림공원,39351,720,1679,720,1679,0,77
수변로삼거리,40367,848,367,848,367,0,39
수변로삼거리,40370,2656,4896,2653,4896,3,243
수봉공원,37289,1576,1361,1576,1361,0,94
수봉공원,37569,1122,3182,1122,3182,0,138
수봉공원.인천수봉문화회관입구,37362,11850,6371,11782,6371,68,587
수봉공원.인천수봉문화회관입구,37369,8328,13062,8296,13062,32,690
수봉마을쉼터,37570,2860,3486,2860,3486,0,204
수봉마을쉼터,37571,2752,1808,2752,1808,0,147
수부촌,43041,158,176,158,176,0,10
수산동,39175,294,650,294,650,0,30
수산동,39176,236,379,236,379,0,19
수양관,43245,22,76,22,76,0,3
수양관,43645,90,25,90,25,0,3
수인곡물시장,35134,2695,2475,2662,2475,33,166
수정제입구,90290,9,9,9,9,0,0
수촌,43111,117,1,113,1,4,3
수촌,43358,2,104,2,104,0,3
수출산업단지6공단입구,40009,3557,4547,3543,4547,14,261
수출산업단지6공단입구,40010,2160,2382,2155,2382,5,146
수행마을.홈플러스,80074,767,34,767,34,0,25
수행마을.홈플러스,80075,96,670,96,670,0,24
수현마을,39487,2248,2806,2235,2806,13,163
수현마을,39488,4513,4422,4486,4422,27,288
수협,43060,157,1061,155,1061,2,39
수협,43062,3433,9790,3401,9790,32,426
수협,,0,1,0,1,0,0
수협(인천해양센터),35080,2473,78,2452,78,21,82
수협(인천해양센터),35081,58,3599,58,3599,0,117
수협온수지점,90411,1283,381,1280,381,3,53
수협온수지점,90413,326,1273,323,1273,3,51
순복음교회,37253,8536,25635,8513,25635,23,1102
순복음교회,39181,17051,7611,16954,7611,97,795
순복음교회,40661,14118,7340,14114,7340,4,692
순천향대학병원.부명고,55037,8419,1128,8402,1128,17,307
숭덕여중고입구,39461,11392,23501,11353,23501,39,1125
숭덕여중고입구,39463,15175,12287,15127,12287,48,885
숭덕여중고입구,39466,6382,970,6308,970,74,237
숭뢰2리,43421,77,235,75,235,2,10
숭뢰2리,43704,227,31,222,31,5,8
숭보사입구,40851,121,26,118,26,3,4
숭보사입구,40918,1,48,1,48,0,1
숭의1.3동(극동아파트),37328,514,526,508,526,6,33
숭의1.3동(극동아파트),37337,537,862,531,862,6,45
숭의2동행정복지센터,37563,1735,2186,1735,2186,0,126
숭의교회,37269,17751,9744,17676,9744,75,886
숭의교회,37271,11786,14405,11739,14405,47,844
숭의로터리,37265,5574,18180,5559,18180,15,766
숭의로터리,37266,15256,5625,15213,5625,43,673
숭의로터리,37273,16842,8049,16803,8049,39,802
숭의로터리.도원체육관,37276,7501,11587,7477,11587,24,615
숭의목공예마을앞,37313,8081,7761,7977,7761,104,511
숭의목공예마을앞,37315,5785,6603,5738,6603,47,399
숭의박문아파트,37353,1432,2387,1425,2387,7,123
숭의박문아파트,37354,2551,1416,2534,1416,17,127
숭의보건지소,37532,13710,4092,13698,4092,12,574
숭의역(1번출구),37510,44987,21230,44930,21230,57,2136
숭의역(2번출구),37211,25865,32642,25836,32642,29,1887
숭의역(3번출구),35133,923,3849,923,3849,0,153
숭의역(4번출구),35135,3440,2172,3438,2172,2,181
숭의초등학교,37296,1033,736,1020,736,13,57
숭의초등학교,37308,1224,3299,1224,3299,0,145
숭의초등학교입구,37287,1843,1438,1840,1438,3,105
쉐보레인천서비스,40433,1463,4303,1461,4303,2,186
쉐보레출고사무소,89160,1874,44,1857,44,17,61
쉴낙원인천장례식장,41458,1419,2394,1419,2394,0,123
스카이시티자이.화성파크드림,35650,2188,5861,2184,5861,4,259
스타파이브입구,35428,267,47,243,47,24,10
스타파이브입구,35429,26,209,26,209,0,7
스태츠칩팩코리아,35641,11,595,11,595,0,19
스태츠칩팩코리아,35642,430,4,430,4,0,14
스틸랜드,70228,135,562,126,562,9,22
스틸랜드,70229,407,161,403,161,4,18
스포월드골프연습장,42439,67,131,66,131,1,6
스포월드골프연습장,42440,8,102,8,102,0,3
승기천,39169,1003,5983,1003,5983,0,225
승기천,39170,456,4265,455,4265,1,152
시대아파트,38340,13211,11633,13198,11633,13,801
시리미,43330,49,46,48,46,1,3
시리미,43631,17,0,17,0,0,0
시립가좌테니스장,37581,244,1309,244,1309,0,50
시립가좌테니스장,37582,217,2879,217,2879,0,99
시민공원,37359,13470,5392,13424,5392,46,608
시민공원(문화창작지대)역,37344,23450,21953,23402,21953,48,1464
시민공원(문화창작지대)역,37346,31886,27154,31801,27154,85,1904
시민공원.문화창작지대,37334,16771,32697,16725,32697,46,1595
시민공원.문화창작지대,37468,1505,1296,1498,1296,7,90
시민공원역.포레나미추홀,37319,4693,42479,4680,42479,13,1521
시민공원역.포레나미추홀,37326,90849,17770,90743,17770,106,3503
시민의숲.양재꽃시장,31002,12705,3685,12705,3685,0,528
시민의숲.양재꽃시장,31003,1653,4604,1653,4604,0,201
시장로터리(중앙철재),40261,2062,1833,2055,1833,7,125
시청광장입구,39217,17122,21833,17050,21833,72,1256
시청광장입구,39218,21876,16961,21832,16961,44,1252
시흥대야역.영남아파트,70027,382,1745,382,1745,0,68
시흥대야역.영남아파트,70028,1870,731,1862,731,8,83
시흥보건소,70015,1809,426,1793,426,16,72
시흥보건소,70016,359,1629,355,1629,4,64
시흥영업소,25846,145,115,145,115,0,8
시흥영업소,25847,62,130,62,130,0,6
신골입구,43998,19,41,18,41,1,1
신골입구,43999,31,13,30,13,1,1
신광주유소,43470,26,4,26,4,0,0
신광주유소,43524,2,34,2,34,0,1
신광초등학교,35142,342,473,336,473,6,26
신기.남부종합시장(진흥사거리),37217,47515,29260,47415,29260,100,2476
신기.남부종합시장(진흥사거리),37219,15640,28779,15599,28779,41,1432
신김포농협대곶지점,80147,47,20,47,20,0,2
신김포농협대곶지점,80148,119,164,119,164,0,9
신논현역,32055,10344,123,10344,123,0,337
신논현역.우신빌딩,31057,77,6476,77,6476,0,211
신당리동촌부락,90090,35,0,35,0,0,1
신당리동촌부락,90091,1,6,1,6,0,0
신당리마을회관,90087,0,3,0,3,0,0
신당촌,90114,8,7,8,7,0,0
신대진중앙아파트,41271,3944,2873,3940,2873,4,219
신대진중앙아파트,41274,2037,3566,2037,3566,0,180
신도실업(주),40625,631,1788,631,1788,0,78
신동마을,90253,2,2,1,2,1,0
신동마을,90254,8,2,7,2,1,0
신동아1.2차아파트,37507,8508,5884,8495,5884,13,464
신동아1단지,70038,78,200,71,200,7,8
신동아1단지.한일아파트,70037,196,87,194,87,2,9
신동아3차아파트,37119,11046,16026,11040,16026,6,873
신동아3차아파트,37120,11206,16930,11199,16930,7,907
신동아3차아파트,37494,9394,5342,9368,5342,26,475
신동아상가,40860,5559,3476,5559,3476,0,291
신동아상가(백운역방면),40068,5130,7890,5130,7890,0,420
신동아아파트,37072,7,908,7,908,0,29
신동아아파트,37143,6521,12462,6511,12462,10,612
신동아아파트,37160,4953,7807,4944,7807,9,411
신동아아파트,37525,1896,7197,1888,7197,8,293
신동아아파트,39381,2795,6276,2791,6276,4,292
신동아아파트,39382,15868,6276,15845,6276,23,714
신동아아파트,41349,6264,1052,6251,1052,13,236
신동아아파트,41350,1593,5171,1589,5171,4,218
신동아아파트(B),37162,11591,9813,11577,9813,14,690
신동아아파트116동,40060,3415,11678,3415,11678,0,486
신동아아파트116동,40859,7268,2421,7268,2421,0,312
신동아아파트3차,37090,9489,865,9476,865,13,334
신동아아파트3차,37097,2922,9043,2917,9043,5,385
신동아아파트4차,37121,4350,1456,4338,1456,12,187
신동아아파트4차,37123,2169,3248,2160,3248,9,174
신동아아파트5차,37141,12340,3632,12320,3632,20,515
신동아아파트8차,37135,1204,3115,1202,3115,2,139
신동아아파트8차,37136,4111,787,4107,787,4,158
신동양아파트,41202,3276,9412,3274,9412,2,409
신동양아파트,41203,7713,3809,7713,3809,0,371
신라아파트,37277,6490,6410,6466,6410,24,416
신라아파트,37543,1877,3807,1870,3807,7,183
신명보람마을.삼부한신아파트,40511,2306,2575,2305,2575,1,157
신명보람마을.삼부한신아파트,40512,548,928,544,928,4,47
신명스카이뷰,35453,1164,2900,1164,2900,0,131
신명스카이뷰,35456,9295,4566,9293,4566,2,447
신명스카이뷰,42737,90,197,90,197,0,9
신명스카이뷰정문,35455,5379,8960,5379,8960,0,462
신명아파트,42081,7991,11860,7967,11860,24,640
신명아파트.대우3차아파트,70018,289,2583,286,2583,3,92
신명아파트앞,42799,11,794,11,794,0,25
신반포역.세화여중고,31033,668,98,668,98,0,24
신봉삼거리,43126,110,8,108,8,2,3
신봉삼거리,43127,1,11,0,11,1,0
신봉삼거리,43463,113,77,109,77,4,6
신봉삼거리,43814,12,11,12,11,0,0
신봉이발관,43458,22,7,22,7,0,0
신봉이발관,43786,5,46,5,46,0,1
신북항고가교,42104,2691,2405,2679,2405,12,164
신북항고가교,42109,1568,3007,1565,3007,3,147
신분당선.강남역4번출구,23572,9179,3712,9179,3712,0,415
신비마을아파트,37164,369,1532,362,1532,7,61
신비마을아파트,37223,3804,7355,3788,7355,16,359
신비마을아파트,37225,6135,3731,6115,3731,20,318
신비마을아파트,37555,225,832,223,832,2,34
신비마을아파트(112동),37171,3959,2990,3936,2990,23,224
신삼1리마을회관,43405,163,0,158,0,5,5
신삼1리마을회관,43791,2,152,2,152,0,4
신삼2리마을회관,43400,137,0,134,0,3,4
신삼2리마을회관,43825,14,113,12,113,2,4
신삼리입구,43606,16,4,15,4,1,0
신삼리입구,43801,0,28,0,28,0,0
신선지입구,90346,17,7,17,7,0,0
신선지입구,90347,0,32,0,32,0,1
신선초등학교,35086,5670,10022,5653,10022,17,506
신선초등학교,35089,10148,3659,10131,3659,17,445
신선초등학교앞,37055,2381,741,2372,741,9,100
신설동,35413,19,56,19,56,0,2
신설동,35416,47,7,47,7,0,1
신설동(3거리),35018,102,6,99,6,3,3
신설동(3거리),35019,12,153,12,153,0,5
신성미소지움,40099,2558,20,2511,20,47,83
신성미소지움,40102,33,1880,16,1880,17,61
신성미소지움,40643,1916,14264,1915,14264,1,521
신성미소지움,40649,7180,2047,7177,2047,3,297
신성미소지움후문,40660,4,473,4,473,0,15
신성성결교회(올림피아병원),39355,13951,9603,13927,9603,24,759
신세계아파트,39383,3223,4818,3217,4818,6,259
신송고등학교,38023,1131,3008,1124,3008,7,133
신송고등학교,38024,2204,1994,2202,1994,2,135
신안실크밸리,35220,878,254,878,254,0,36
신연수역(1번출구),38263,4693,3925,4676,3925,17,278
신연수역(2번출구),38231,2982,660,2982,660,0,117
신연수역(3번출구),38228,6509,4446,6491,4446,18,353
신영자동차,40561,3106,681,3098,681,8,122
신영자동차(종점),40556,5319,2244,5250,2244,69,243
신왕마을,43203,215,0,214,0,1,6
신왕마을,43718,2,192,2,192,0,6
신원기술,39130,24,12,24,12,0,1
신원아침도시오피스텔(홈플러스),39836,5540,6444,5531,6444,9,386
신일교회,39529,4689,7073,4679,7073,10,379
신일아파트,35097,47,19,47,19,0,2
신정1리마을회관,43300,26,11,26,11,0,1
신정1리마을회관,43737,26,12,26,12,0,1
신정삼거리,90111,0,17,0,17,0,0
신정삼거리,90112,3,0,3,0,0,0
신정중학교,38459,1445,1076,1445,1076,0,81
신정중학교,38555,1316,1457,1316,1457,0,89
신중동역4번출구.롯데백화점,55226,1263,4397,1263,4397,0,182
신중동역5번출구.중흥중학교,55071,495,4240,495,4240,0,152
신중동역6번출구.중흥중학교,55072,2528,429,2528,429,0,95
신지동마을회관,43303,70,63,68,63,2,4
신지동마을회관,43740,128,36,127,36,1,5
신진아파트,41107,23967,14364,23958,14364,9,1236
신창아파트,37010,3553,5980,3553,5980,0,307
신창아파트,37464,4487,2376,4485,2376,2,221
신천동,70048,5668,393,5601,393,67,195
신천동,70049,269,5760,267,5760,2,194
신천삼거리,70013,6352,420,6319,420,33,218
신천삼거리,70014,426,6628,419,6628,7,227
신천역.문화의거리,25364,1668,311,1668,311,0,63
신천역.문화의거리,70174,202,1820,202,1820,0,65
신천연합병원,70175,62,663,62,663,0,23
신천연합병원,70231,776,210,776,210,0,31
신촌,43146,22,0,22,0,0,0
신촌,43432,9,11,8,11,1,0
신촌,43459,295,15,293,15,2,10
신촌,43510,0,5,0,5,0,0
신촌,43753,23,171,23,171,0,6
신촌,43800,68,78,67,78,1,4
신촌마을입구,90201,31,13,30,13,1,1
신촌마을입구,90202,4,10,3,10,1,0
신촌역2호선,22052,2943,37,2943,37,0,96
신촌오거리.2호선신촌역,22014,4783,62,4783,62,0,156
신촌오거리.2호선신촌역,23035,134,2621,134,2621,0,88
신촌오거리.현대백화점,22013,9698,88,9698,88,0,315
신촌오거리.현대백화점,23034,381,12823,381,12823,0,425
신촌초등학교,40098,275,907,275,907,0,38
신태양아파트,37406,4752,7770,4751,7770,1,403
신태양아파트,37408,9019,3124,9019,3124,0,391
신트리공원,40472,2380,2376,2380,2376,0,153
신트리공원,40496,2444,4164,2437,4164,7,213
신트리공원,40501,1995,1547,1993,1547,2,114
신포동행정복지센터,35153,2730,2218,2714,2218,16,159
신포동행정복지센터,35154,1874,2722,1866,2722,8,148
신포사거리,35791,31,367,31,367,0,12
신포시장,35160,28037,49249,27913,49249,124,2493
신포시장,35254,50380,29926,50228,29926,152,2590
신포역·인천세관역사공원,35792,150,170,150,170,0,10
신포역·인천세관역사공원,35796,28,14,28,14,0,1
신포역·인천여자상업고등학교,35149,1534,5986,1518,5986,16,242
신포역·인천여자상업고등학교,35150,5945,2374,5940,2374,5,268
신포입구,43491,57,40,55,40,2,3
신포입구,43842,20,29,20,29,0,1
신한빌딩,39901,10968,9332,10962,9332,6,654
신한에이엠,89147,665,16,665,16,0,21
신한일전기,39034,1875,1013,1875,1013,0,93
신현119안전센터,42596,7724,12320,7682,12320,42,646
신현119안전센터,42600,7410,7896,7379,7896,31,493
신현노인회관,43279,55,10,52,10,3,2
신현노인회관,43527,17,56,16,56,1,2
신현리입구,90062,25,62,25,62,0,2
신현북초등학교,42208,4124,240,4118,240,6,140
신현북초등학교,42209,271,3303,271,3303,0,115
신현북초등학교,42210,1756,289,1755,289,1,65
신현북초등학교,42211,114,1757,113,1757,1,60
신현쇼핑,42217,31841,23725,31620,23725,221,1792
신현쇼핑,42220,40995,25138,40891,25138,104,2133
신현여자중학교후문,42214,2648,3625,2639,3625,9,202
신현여자중학교후문,42680,3270,1942,3262,1942,8,168
신현중학교,42205,115,3220,115,3220,0,107
신현초등학교,42178,1440,1651,1436,1651,4,99
신현초등학교,42179,1845,2930,1841,2930,4,154
신화빌라,42626,489,369,489,369,0,27
신화슈퍼,89314,84,3,82,3,2,2
신화슈퍼,89326,2,131,2,131,0,4
신흥교통,35501,240,6,228,6,12,7
신흥교통입구,35841,1417,18,1398,18,19,46
신흥동주민자치센터,35789,53,64,53,64,0,3
신흥동주민자치센터,35799,21,19,21,19,0,1
신흥시장,35145,10758,13979,10731,13979,27,797
신흥시장,35146,14295,8256,14254,8256,41,727
신흥시장,57002,2581,1315,2581,1315,0,125
신흥시장,57004,1672,2615,1672,2615,0,138
신흥시장후문,35812,84,40,84,40,0,4
신흥시장후문,35813,101,111,101,111,0,6
신흥주민지원센터,57013,3307,1775,3307,1775,0,163
신흥주민지원센터,57014,1618,3093,1618,3093,0,151
신흥초등학교,35156,7195,9168,7163,9168,32,527
실내게이트볼장(신현중학교),42204,4394,102,4363,102,31,145
실미도조개구이,35299,2,33,2,33,0,1
실미삼거리,35740,403,54,399,54,4,14
실미삼거리,35741,37,230,37,230,0,8
심곡극동아파트,42272,1599,282,1592,282,7,60
심곡극동아파트,42273,179,964,179,964,0,36
심곡도서관,42946,2048,1438,2043,1438,5,112
심곡도서관,89223,545,2191,543,2191,2,88
심곡동광명아파트,89153,6273,2252,6266,2252,7,275
심곡동광명아파트,89154,2144,4162,2140,4162,4,203
심곡천(심곡3교),89381,140,21,140,21,0,5
심곡천(심곡3교),89382,9,276,9,276,0,9
심곡천봉수교,42875,870,592,867,592,3,47
심곡천봉수교,42951,1533,4395,1533,4395,0,191
심곡초등학교(국제성모병원),42288,4046,5137,4032,5137,14,296
심곡초등학교(국제성모병원),42290,5763,4213,5751,4213,12,321
십리포제2주차장,44110,9,17,9,17,0,0
십리포제2주차장,44207,1,0,1,0,0,0
십리포해수욕장,44088,27,56,27,56,0,2
십리포해수욕장,44208,32,8,32,8,0,1
십정1동행정복지센터,40049,17118,13909,17084,13909,34,1000
십정2동행정복지센터,40056,5272,5852,5263,5852,9,358
십정동차고지,40913,3185,352,3176,352,9,114
십정사거리,40029,6566,5529,6557,5529,9,390
십정사거리,40033,3370,3548,3362,3548,8,223
십정시장입구,40007,17,3329,17,3329,0,107
십정시장입구,40008,3348,23,3348,23,0,108
십정초등학교(동암의원),40041,1294,1191,1254,1191,40,80
십정초등학교(동암의원),40042,685,2642,679,2642,6,107
십정초등학교·더샵부평정문,40045,17743,20201,17684,20201,59,1224
십정초등학교·더샵부평정문,40048,27497,18749,27450,18749,47,1491
쌍마아파트,42112,5391,3213,5373,3213,18,277
쌍마아파트,42114,572,2189,570,2189,2,89
쌍용아파트,37179,5080,2358,5032,2358,48,239
쌍용아파트,37186,1665,3837,1653,3837,12,177
쌍용아파트,37210,667,462,667,462,0,36
쌍용아파트,37228,18815,11159,18766,11159,49,966
쌍용아파트,37476,13857,21807,13805,21807,52,1150
쌍용아파트,38178,1933,756,1933,756,0,86
쌍용아파트,38184,737,1693,733,1693,4,78
쌍용아파트,38469,4113,2769,4081,2769,32,222
쌍용아파트,41434,1415,4125,1415,4125,0,178
쌍용아파트정문,40439,2395,2839,2376,2839,19,168
쌍용자동차인천정비사업소,36144,80,1029,80,1029,0,35
쑥골고가교,37371,2949,2721,2940,2721,9,182
쑥골고가교,37372,4583,8021,4568,8021,15,406
쑥밭다리,43650,7,14,7,14,0,0
쑥밭다리,43683,15,7,14,7,1,0
아나지고개,41001,2557,2996,2552,2996,5,179
아나지고개,41002,3990,6057,3983,6057,7,324
아동보호센터,35680,57,281,54,281,3,10
아동보호센터,35698,77,36,69,36,8,3
아라노을공원·한신더휴,89404,9828,7632,9821,7632,7,563
아라노을공원·한신더휴,89405,7446,8943,7428,8943,18,528
아라동행정복지센터,42465,14161,17834,14141,17834,20,1032
아라동행정복지센터,42467,13803,9283,13796,9283,7,744
아라동행정복지센터(서부고용센터),89401,2798,1035,2798,1035,0,123
아라동행정복지센터(서부고용센터),89402,1244,4232,1244,4232,0,176
아라뱃길물류센터,89145,5,333,5,333,0,10
아라센트럴파크,89406,2439,3705,2427,3705,12,198
아라센트럴파크,89407,4733,3541,4726,3541,7,266
아름어린이공원,40337,249,578,249,578,0,26
아름어린이공원,40339,769,538,769,538,0,42
아리마을쉼터,37551,5,1188,5,1188,0,38
아리마을쉼터,37552,1364,238,1334,238,30,51
아모텍,39139,1585,2765,1585,2765,0,140
아시아드경기장(공촌사거리)역,42319,1971,3941,1970,3941,1,190
아시아드경기장(공촌사거리)역,42320,408,1268,401,1268,7,54
아시아드대광로제비앙아파트,89257,969,3479,969,3479,0,143
아시아드대광로제비앙아파트,89258,4700,1479,4699,1479,1,199
아암3교사거리,38727,49,289,49,289,0,10
아암3교사거리,38728,94,150,94,150,0,7
아암물류단지,35285,166,1,156,1,10,5
아암물류단지,35590,2,157,1,157,1,5
아울렛(CGV부평),40818,3525,2038,3517,2038,8,179
아이즈빌(부평CGV),40595,11116,7066,11098,7066,18,586
아이즈빌(부평CGV),40598,8619,11517,8608,11517,11,649
아인스월드,55086,510,1291,508,1291,2,58
아주아파트,38047,1538,767,1527,767,11,74
아주아파트,38051,790,1409,777,1409,13,70
아주아파트,38301,1468,791,1463,791,5,72
아주아파트,38304,2159,1434,2151,1434,8,115
아주아파트.미추홀학교,39481,38762,16783,38625,16783,137,1791
아주아파트.미추홀학교,39482,19358,22939,19319,22939,39,1364
아주아파트410동,41575,448,2,448,2,0,14
아침가리마을회관,43287,137,0,134,0,3,4
아침가리마을회관,43867,0,102,0,102,0,3
아쿠아글로리,42811,142,1,142,1,0,4
아트센터인천,38617,18,36,18,36,0,1
아트센터인천,38618,9,62,9,62,0,2
아현역,22062,2685,25,2685,25,0,87
아현역,23078,12,1790,12,1790,0,58
안골마을입구,38225,7093,7743,7087,7743,6,478
안남고(동보1차아파트),41048,747,570,742,570,5,42
안남고등학교,41045,3085,750,3083,750,2,123
안동포교회,42700,483,122,483,122,0,19
안동포교회,42701,54,654,54,654,0,22
안동포사거리,42707,13,151,13,151,0,5
안동포사거리입구,42765,402,18,401,18,1,13
안동포사거리입구,42766,14,917,6,917,8,30
안산마을,43132,41,1,41,1,0,1
안산마을,43138,3,49,3,49,0,1
안산초등학교(구계산고교),41425,15309,12617,15293,12617,16,900
안양대학교,43177,182,304,180,304,2,15
안양대학교,43301,154,164,153,164,1,10
안풍산업삼거리,89312,105,5,100,5,5,3
안풍산업삼거리,89329,1,77,1,77,0,2
알앤디써비스,38477,132,1002,128,1002,4,36
알앤디써비스,38478,754,178,754,178,0,30
애관극장,35804,22,60,22,60,0,2
애보박물관,39667,0,18,0,18,0,0
애보박물관,39671,0,30,0,30,0,0
애전마을,43682,19,9,19,9,0,0
애전마을,43894,21,19,21,19,0,1
애전부락,90075,32,89,32,89,0,3
애전부락,90076,63,42,63,42,0,3
앰코코리아(블루오션골프클럽),39880,1072,49,1072,49,0,36
야곡,43236,48,4,48,4,0,1
야곡,43292,5,87,5,87,0,2
야촌,43210,6,0,6,0,0,0
야촌,43333,0,5,0,5,0,0
약대사거리,57006,2535,529,2535,529,0,98
약대사거리,57010,384,2690,384,2690,0,99
약대주민지원센터.약대초등학교,55080,959,1761,959,1761,0,87
약대주민지원센터.약대초등학교,55088,1631,551,1631,551,0,70
약암호텔,80071,414,87,411,87,3,16
약암호텔,80072,38,439,37,439,1,15
얀센백신,38519,151,0,151,0,0,4
얀센백신,38520,1,484,1,484,0,15
양갑리마을회관,90283,2,60,2,60,0,2
양갑리마을회관,90307,50,0,50,0,0,1
양갑리입구,90282,1,13,1,13,0,0
양갑리입구,90308,19,2,19,2,0,0
양곡도매시장,31037,1639,407,1639,407,0,66
양곡버스정류장,80115,157,620,154,620,3,25
양곡사거리.양촌터미널,80116,437,137,432,137,5,18
양골,43987,19,0,19,0,0,0
양골,43989,0,40,0,40,0,1
양구(오상1리),43262,0,49,0,49,0,1
양구(오상1리),43563,61,2,59,2,2,2
양달마을,43910,62,54,62,54,0,3
양달마을,43911,7,1,7,1,0,0
양도,43074,1,19,1,19,0,0
양도,43075,27,36,27,36,0,2
양도면사무소(나무),43912,359,404,353,404,6,24
양도면사무소(쉘터),43913,610,387,592,387,18,32
양도사거리.대림아파트.신안아파트,80076,806,56,806,56,0,27
양도사거리.삼용아파트,80077,119,807,119,807,0,29
양도초등학교,43329,216,100,208,100,8,10
양도초등학교,43568,115,177,114,177,1,9
양로원,40111,428,2507,428,2507,0,94
양로원,40113,2133,369,2133,369,0,80
양사면사무소,43501,17,41,17,41,0,1
양사면사무소,43658,47,65,45,65,2,3
양사우체국,43465,41,18,41,18,0,1
양사우체국,43736,24,60,24,60,0,2
양사초등학교,43466,81,18,76,18,5,3
양사초등학교,43734,26,52,19,52,7,2
양사파출소,43722,13,15,13,15,0,0
양수장,43592,124,0,123,0,1,4
양수장,43781,0,110,0,110,0,3
양오1리마을회관,43454,2,61,2,61,0,2
양오1리마을회관,43666,71,1,66,1,5,2
양오2리경로당,43453,6,61,6,61,0,2
양오2리경로당,43625,160,5,159,5,1,5
양오2리앞,90049,0,20,0,20,0,0
양오리저수지마을,90102,0,23,0,23,0,0
양오리저수지마을,90103,99,0,97,0,2,3
양오저수지입구,90100,0,7,0,7,0,0
양오저수지입구,90101,13,0,13,0,0,0
양왕마을,43927,5,6,5,6,0,0
양왕마을,43928,11,42,11,42,0,1
양재역,31073,13303,4030,13303,4030,0,559
양재역.서초문화예술회관,31008,2549,3842,2549,3842,0,206
양재역.서초문화예술회관,31010,2473,2004,2473,2004,0,144
양재역말죽거리.강남베드로병원,23318,290,142,290,142,0,13
양지공원,38133,7260,4836,7253,4836,7,390
양지촌,43163,10,5,10,5,0,0
양지촌,43342,14,16,14,16,0,0
양진말입구,90057,1,43,1,43,0,1
양촌중학교,41629,408,903,408,903,0,42
양촌중학교,41630,253,306,253,306,0,18
양평해장국,44145,7,6,5,6,2,0
양평해장국,44178,2,8,2,8,0,0
어두,43206,2,9,2,9,0,0
어두,43280,1,0,1,0,0,0
어두마을,43155,78,11,77,11,1,2
어두마을,43322,11,52,11,52,0,2
어류정입구,90175,32,20,31,20,1,1
어류정입구,90176,16,30,16,30,0,1
어류정입구,90312,2,2,2,2,0,0
어류정항,90323,1,2,1,2,0,0
어류정항,90400,1,1,1,1,0,0
어린이집앞,43402,131,0,124,0,7,4
어린이집앞,43585,11,130,11,130,0,4
에덴하우스,42788,582,1231,582,1231,0,58
에몬스가구,39023,3245,4169,3242,4169,3,239
에몬스가구,39024,4798,2405,4798,2405,0,232
에스틸,89232,265,54,265,54,0,10
에이에프티,39110,1213,2739,1213,2739,0,127
에코메트로10단지,39728,448,202,448,202,0,20
에코메트로10단지,39736,105,356,105,356,0,14
에코메트로11단지,39652,2645,4027,2642,4027,3,215
에코메트로11단지후문,39701,602,1676,602,1676,0,73
에코메트로12단지,39651,3218,2093,3217,2093,1,171
에코메트로12단지,39653,17,669,16,669,1,22
에코메트로12단지정문,39650,74,130,74,130,0,6
에코메트로5단지,92076,27,137,27,137,0,5
에코메트로5단지·논현센트럴뷰,39779,660,1104,660,1104,0,56
에코메트로6단지,39716,3158,184,3151,184,7,107
에코메트로6단지,39758,45,888,45,888,0,30
에코메트로7단지,39714,9778,4317,9772,4317,6,454
에코메트로7단지,39715,4808,7091,4808,7091,0,383
에코메트로9단지,39750,5780,1154,5777,1154,3,223
에코메트로9단지,39752,1921,3612,1921,3612,0,178
에코메트로더타워,39711,56,620,53,620,3,21
에코크레이션,89449,298,1,298,1,0,9
에코크레이션,89450,1,113,1,113,0,3
엑스포빌리지10단지,38460,2186,1238,2183,1238,3,110
엑스포빌리지9단지,38482,2290,6614,2290,6614,0,287
엑슬루타워,37187,3232,8828,3216,8828,16,389
엑슬루타워,42836,3008,11875,3007,11875,1,480
엘리지안타운,42394,1324,1356,1319,1356,5,86
엘아이지식산업센터,39944,262,1102,262,1102,0,44
엘아이지식산업센터(맞은편),92029,792,384,792,384,0,37
엘지슈퍼,39457,1103,2105,1103,2105,0,103
엠파크타워,42025,4139,4926,4135,4926,4,292
엠파크타워,42026,5230,4418,5223,4418,7,311
여고입구,90232,338,368,325,368,13,22
여고입구,90233,870,520,860,520,10,44
여성의광장,38084,3697,3762,3693,3762,4,240
여성의광장,38085,4105,4717,4091,4717,14,284
여우고개,43980,29,99,27,99,2,4
여우고개,43981,75,52,74,52,1,4
여우별펜션,44142,1,5,0,5,1,0
여우별펜션,44179,6,2,4,2,2,0
여우재,35147,400,346,400,346,0,24
여의도역,19155,405,2,405,2,0,13
여의도역,19156,148,1259,148,1259,0,45
여의도환승센터,19007,13,617,13,617,0,20
여차리,43424,16,27,16,27,0,1
여차리,43472,37,31,36,31,1,2
여차리회관,43505,45,16,44,16,1,1
여차리회관,43525,26,19,24,19,2,1
역삼역.포스코타워역삼,23288,1292,1191,1292,1191,0,80
연락골,39662,2,26,2,26,0,0
연락골,39665,17,7,16,7,1,0
연리입구,43267,60,0,60,0,0,1
연리입구,43614,0,28,0,28,0,0
연미고개,43198,0,103,0,103,0,3
연미고개,43711,115,0,112,0,3,3
연미정,43193,157,1,142,1,15,5
연미정,43621,0,118,0,118,0,3
연성교회,37278,5350,4928,5325,4928,25,331
연세농장,39851,27,1,27,1,0,0
연세대,39725,1395,3376,1395,3376,0,153
연세대,39861,2897,1900,2897,1900,0,154
연세대송도캠퍼스입구,38489,8294,4589,8294,4589,0,415
연세대앞,22022,16,9,16,9,0,0
연세대학교앞,22058,2429,38,2429,38,0,79
연수1동행정복지센터,38248,234,546,233,546,1,25
연수1동행정복지센터,38251,1269,1083,1238,1083,31,75
연수1차아파트,38187,5017,2817,5012,2817,5,252
연수2차아파트,38195,614,1349,594,1349,20,63
연수3동행정복지센터,38262,1435,658,1435,658,0,67
연수경찰서,38111,2672,2591,2669,2591,3,169
연수고등학교,38104,521,2452,518,2452,3,95
연수구청,38089,8551,4829,8542,4829,9,431
연수구청,38093,4000,10201,3998,10201,2,458
연수구청입구,38095,5876,4479,5876,4479,0,334
연수꿈담도서관,38103,8504,6322,8494,6322,10,478
연수병원,38296,4905,2573,4876,2573,29,241
연수여자고등학교,38092,2023,2699,2022,2699,1,152
연수역,38506,2360,2664,2348,2664,12,162
연수역,38507,1274,2097,1272,2097,2,108
연수역북측입구,38572,1171,2338,1171,2338,0,113
연수역북측입구,38573,1769,1853,1768,1853,1,116
연수우체국,38280,6570,4153,6570,4153,0,345
연수우체국,38314,2096,1035,2096,1035,0,101
연수주공3차아파트,38188,3749,3891,3745,3891,4,246
연수중학교,38194,1881,1533,1857,1533,24,110
연수중학교,38196,994,957,993,957,1,62
연수초등학교,38290,9782,9406,9763,9406,19,618
연수초등학교,38293,3772,3609,3772,3609,0,238
연수한양1차아파트,38091,2551,5025,2551,5025,0,244
연안동행정복지센터,35063,156,10342,154,10342,2,338
연안부두(신선초등학교),35097,762,3383,745,3383,17,133
연안부두로삼거리,35754,1,714,1,714,0,23
연안부두바다쉼터,35049,1073,25,1060,25,13,35
연안부두어시장,35071,81,7068,79,7068,2,230
연안부두어시장,35072,7851,161,7811,161,40,258
연안아파트,35075,9567,2095,9538,2095,29,376
연안아파트,35076,1308,10092,1299,10092,9,367
연안여객터미널,35057,5531,64,5488,64,43,180
연안여객터미널,35061,32,3600,27,3600,5,117
연안여객터미널,90115,69,23,69,23,0,2
연안여객터미널,90116,15,59,14,59,1,2
연안여객터미널입구,35068,1673,64,1639,64,34,56
연안초등학교,35064,16685,290,16501,290,184,547
연안초등학교,35067,135,12406,134,12406,1,404
연지-기점,90256,2828,2692,2828,2692,0,178
연학초등학교,37137,7158,1830,7142,1830,16,289
연학초등학교,37138,1347,6980,1335,6980,12,268
연합의원,42186,3876,1541,3862,1541,14,174
연화중학교,38117,2384,2788,2379,2788,5,166
연흥아파트,37567,3206,4125,3197,4125,9,236
연흥아파트,37568,2244,6265,2237,6265,7,274
연희공원,42950,61,120,61,120,0,5
연희동광명아파트(사계절썰매장),42314,1525,1786,1524,1786,1,106
연희동광명아파트(사계절썰매장),42599,1416,1937,1414,1937,2,108
연희동행정복지센터,42311,691,1268,691,1268,0,63
연희동행정복지센터,42312,1550,999,1544,999,6,82
열우물사거리,40052,0,304,0,304,0,9
열우물전통시장,40028,488,2414,480,2414,8,93
열우물전통시장,40030,1985,496,1961,496,24,80
열우물전통시장입구,40036,2550,557,2510,557,40,100
열우물전통시장입구,40038,411,3834,406,3834,5,136
열우물테니스경기장,40053,3826,3432,3807,3432,19,234
열우물테니스경기장,40054,788,1092,786,1092,2,60
열우물테니스경기장,40063,372,1255,366,1255,6,52
열우물테니스경기장,40064,368,654,368,654,0,32
열우물테니스경기장,42023,4397,4997,4377,4997,20,303
열우물테니스경기장,42024,3353,3236,3310,3236,43,212
염전공원,37681,2008,8,1974,8,34,65
영골,43954,5,1,5,1,0,0
영골,43955,0,39,0,39,0,1
영남1단지.고합아파트,70164,199,228,197,228,2,13
영남아파트,37060,4381,3864,4381,3864,0,265
영남아파트,37063,5354,4763,5354,4763,0,326
영남아파트,38203,2508,1414,2486,1414,22,126
영남아파트,38205,1041,2899,1032,2899,9,127
영림몰딩도어,39943,88,115,88,115,0,6
영림산업,39028,803,3960,803,3960,0,153
영림임업,39026,1115,4104,1115,4104,0,168
영사목장 앞,90390,0,16,0,16,0,0
영사목장 앞,90391,0,6,0,6,0,0
영선고등학교,40853,0,244,0,244,0,7
영은교회,43037,55,22,53,22,2,2
영은교회,43139,2,120,2,120,0,3
영은슈퍼,89052,9,860,9,860,0,28
영은슈퍼,89064,900,15,900,15,0,29
영음교회.효성해링턴플레이스,41422,3169,529,3159,529,10,119
영종KCC스위첸.한양수자인,35449,332,2843,332,2843,0,102
영종KCC스위첸옆문,35755,948,7617,946,7617,2,276
영종KCC스위첸옆문,35756,8045,570,8043,570,2,277
영종LH2단지,35483,592,1233,591,1233,1,58
영종LH67단지,35872,837,992,836,992,1,59
영종LH67단지,35873,1591,823,1591,823,0,77
영종LH아파트입구,35390,84,79,84,79,0,5
영종e편한세상센텀베뉴·센트럴푸르지오자이,35660,5679,3841,5677,3841,2,307
영종e편한세상센텀베뉴·화성파크드림2차,35886,4279,4397,4278,4397,1,279
영종고등학교,35493,802,1291,802,1291,0,67
영종고등학교,35496,870,1622,870,1622,0,80
영종공원묘지입구,35626,2,44,2,44,0,1
영종공원묘지입구,35627,4,5,4,5,0,0
영종교회,35306,361,284,361,284,0,20
영종교회,35545,988,764,988,764,0,56
영종국제병원,35881,587,2615,587,2615,0,103
영종대교휴게소,42942,3,60,3,60,0,2
영종대교휴게소,42943,72,18,72,18,0,2
영종동행정복지센터,35672,205,213,205,213,0,13
영종동행정복지센터,35673,129,48,128,48,1,5
영종물류고등학교·영종자이아파트,35314,4131,3296,4129,3296,2,239
영종물류고등학교앞·영종자이아파트,35307,4986,4031,4985,4031,1,290
영종버스공영차고지,35837,49,3,47,3,2,1
영종버스공영차고지,35838,9,131,3,131,6,4
영종블루오션,35819,238,168,235,168,3,13
영종블루오션,35820,104,191,103,191,1,9
영종블루오션2차,35876,3273,1789,3273,1789,0,163
영종블루오션2차,35877,1944,3474,1944,3474,0,174
영종선착장입구,35833,1789,1893,1783,1893,6,118
영종선착장입구,35834,15,535,14,535,1,17
영종성당.정도사,35850,9,86,9,86,0,3
영종성당.정도사,35851,4,18,4,18,0,0
영종센트럴푸르지오자이·e편한세상센텀베뉴,35661,5674,4687,5674,4687,0,334
영종소방서,35765,5,63,5,63,0,2
영종아레나,35830,114,0,109,0,5,3
영종아레나,35831,4,174,1,174,3,5
영종역,35566,55370,1098,55344,1098,26,1821
영종역,35567,4300,13065,4291,13065,9,560
영종역(2번출구),35870,28,1993,28,1993,0,65
영종역(청라행),35620,50,12395,50,12395,0,401
영종역사관,35624,114,111,114,111,0,7
영종역사관,35625,59,162,58,162,1,7
영종유승한내들스카이스테이,35759,2249,787,2249,787,0,97
영종유승한내들스카이스테이,35760,479,1440,479,1440,0,61
영종자이아파트,35835,14,70,14,70,0,2
영종자이아파트,35836,414,96,414,96,0,16
영종장로교회,35580,20,95,20,95,0,3
영종장로교회,35581,42,12,42,12,0,1
영종주공7단지,35111,1115,1832,1113,1832,2,95
영종주야간보호센터,35854,11,16,11,16,0,0
영종주야간보호센터,35855,6,6,6,6,0,0
영종중학교,35463,652,959,652,959,0,51
영종중학교,35464,1327,501,1327,501,0,58
영종진공원,35276,959,424,958,424,1,44
영종진공원,35279,201,1424,201,1424,0,52
영종풍림아이원1차,35110,127,242,127,242,0,11
영종하늘도서관,35585,1641,1192,1636,1192,5,91
영종하늘도서관,35586,1045,1009,1041,1009,4,66
영종화성파크드림2차·e편한세상센텀베뉴,35885,3801,2952,3801,2952,0,217
영종힐스테이트(904동),35880,544,939,543,939,1,47
영진아파트,40551,65,451,65,451,0,16
영창한의원,40452,7700,6207,7680,6207,20,448
영풍아파트,36040,9533,2602,9487,2602,46,391
영풍아파트,39546,35,354,35,354,0,12
영흥감리교회입구,44201,32,17,32,17,0,1
영흥공립어린이집,44205,6,1,6,1,0,0
영흥면사무소,44131,12,16,0,16,12,0
영흥면사무소,44181,9,2,8,2,1,0
영흥버스터미널,44004,4195,3511,3965,3511,230,248
영흥버스터미널,44116,140,35,129,35,11,5
영흥빌라,44182,2,0,2,0,0,0
영흥수협공판장입구,44009,403,1,393,1,10,13
영흥수협공판장입구,44010,1,680,1,680,0,21
영흥어린이집,44137,12,19,12,19,0,1
영흥우체국,44107,15,22,14,22,1,1
영흥우체국,44183,23,23,23,23,0,1
영흥종합운동장앞,44120,1,19,1,19,0,0
영흥종합운동장앞,44192,38,13,36,13,2,1
영흥초교입구,44101,16,1,15,1,1,0
영흥초교입구,44184,2,19,2,19,0,0
영흥칼국수,44136,2,6,2,6,0,0
영흥플로레도커피,44144,5,14,5,14,0,0
영흥플로레도커피,44185,1,5,1,5,0,0
예단포,35319,103,176,103,176,0,9
예단포,35395,149,72,148,72,1,7
예단포물양장,35622,145,4,144,4,1,4
예단포물양장,35623,22,114,22,114,0,4
예드림빌라입구,35546,69,16,69,16,0,2
예드림빌라입구,35547,39,98,39,98,0,4
예림임업,39053,24,482,24,482,0,16
예림임업,39054,313,107,313,107,0,13
예비군교육장,41272,834,1493,832,1493,2,75
예비군교육장,41273,1801,2117,1789,2117,12,126
예비군교육장입구,90010,24,2,24,2,0,0
예비군교육장입구,90011,1,29,1,29,0,0
예비군훈련장,43201,262,10,262,10,0,8
예비군훈련장,43315,31,223,31,223,0,8
예송중학교,38592,1939,959,1939,959,0,93
예송중학교,38593,1359,2213,1348,2213,11,115
예술회관사거리,37254,3097,6449,3062,6449,35,307
예술회관역,39206,3236,10779,3230,10779,6,452
예술회관역(4번출구),39207,5223,5198,5215,5198,8,336
예원앞,41499,75,141,75,141,0,6
예원앞,41515,57,0,57,0,0,1
옐림교회,40854,5573,4639,5570,4639,3,329
옐림교회앞,35684,34,39,34,39,0,2
옐림교회앞,35694,54,50,53,50,1,3
오공본드,39108,4314,3479,4314,3479,0,251
오관물입구,35859,0,11,0,11,0,0
오관물입구,35860,11,1,11,1,0,0
오두돈대,43361,58,4,54,4,4,2
오두돈대,43536,8,32,8,32,0,1
오두리(넙성입구),43638,23,21,23,21,0,1
오두리(넙성입구),43675,8,32,8,32,0,1
오두리종점,43137,95,7,94,7,1,3
오두리종점,43529,18,81,18,81,0,3
오두마을입구,43557,5,1,5,1,0,0
오두마을입구,43647,0,7,0,7,0,0
오라니마을,80360,89,133,88,133,1,7
오류골,43013,277,77,277,77,0,11
오류골,43014,43,265,43,265,0,9
오류내,43389,5,308,5,308,0,10
오류내,43757,352,18,346,18,6,11
오류동마을,41353,1052,633,1050,633,2,54
오류동마을,41354,921,2300,915,2300,6,103
오류동역입구,89058,0,33,0,33,0,1
오류동역입구,89066,43,330,43,330,0,12
오리정,80125,867,119,854,119,13,31
오리정,80126,141,742,137,742,4,28
오상리고인들,43265,12,13,12,13,0,0
오상리고인들,43379,3,16,3,16,0,0
오상입구,43119,20,2,19,2,1,0
오상입구,43120,0,23,0,23,0,0
오상입구,43390,2,46,2,46,0,1
오상입구,43565,25,7,24,7,1,1
오성교회,43555,17,0,17,0,0,0
오성교회,43853,1,35,1,35,0,1
오성아파트,40480,4142,1199,4128,1199,14,172
오성아파트,40487,989,4021,983,4021,6,161
오성아파트,40493,304,1573,300,1573,4,60
오성아파트,40721,177,369,177,369,0,17
오성정밀,39490,436,620,436,620,0,34
오이도역,70031,650,5265,645,5265,5,190
오이도역,70032,5210,789,5136,789,74,193
오정휴먼시아(중),57044,396,2572,396,2572,0,95
오정휴먼시아(중),57045,2539,292,2539,292,0,91
오조산공원,41246,1676,1109,1672,1109,4,89
오조산공원,41249,3099,2977,3082,2977,17,196
오조산공원,41621,11,354,5,354,6,11
옥골.옥토끼우주센터,43033,119,276,119,276,0,12
옥골.옥토끼우주센터,43561,184,47,184,47,0,7
옥골사거리,38731,144,3516,141,3516,3,118
옥골사거리,38732,155,129,154,129,1,9
옥금말,43952,114,29,82,29,32,4
옥금말,43953,6,82,6,82,0,2
옥련1동행정복지센터,38217,8209,4784,8206,4784,3,419
옥련2동행정복지센터(옥련우체국),38450,2288,166,2288,166,0,79
옥련2동행정복지센터(옥련우체국),38451,492,1865,492,1865,0,76
옥련고개,38212,1517,3311,1516,3311,1,155
옥련고개,38219,903,916,902,916,1,58
옥련동성당,38330,933,2029,933,2029,0,95
옥련사거리,38170,737,1215,737,1215,0,62
옥련사거리,38171,1598,1849,1598,1849,0,111
옥련여고입구,38271,468,294,468,294,0,24
옥련여고입구,38273,700,2523,696,2523,4,103
옥련중학교,38470,2611,4293,2589,4293,22,222
옥련지구대,38223,870,4145,862,4145,8,161
옥련초등학교,38146,3563,4406,3558,4406,5,257
옥림교회,43202,54,0,54,0,0,1
옥림교회,43716,0,56,0,56,0,1
옥림슈퍼,43205,235,9,233,9,2,7
옥림슈퍼,43720,13,79,13,79,0,2
옥림에덴,90418,24,120,24,120,0,4
옥림에덴,90419,20,3,20,3,0,0
온누리병원,42425,210,901,205,901,5,35
온수교차로,90231,0,79,0,79,0,2
온수리,43018,3624,1611,3602,1611,22,168
온수리,43020,2306,2778,2281,2778,25,164
온수시장,43019,67,23,67,23,0,2
온수시장,43095,22,206,21,206,1,7
올리브백화점,39359,3257,1541,3232,1541,25,154
올리브백화점,39363,1764,2082,1757,2082,7,124
올리브백화점,39364,13042,12437,12999,12437,43,821
올리브백화점,39589,14957,17475,14944,17475,13,1046
올리브백화점,39746,13716,16964,13671,16964,45,989
올리브백화점,39747,21194,24657,21136,24657,58,1479
올림픽공원,39209,3583,4803,3565,4803,18,270
올림픽공원,39210,267,728,266,728,1,32
올림픽생활기념관,39349,5111,5641,5105,5641,6,346
옹장골,43171,9,83,9,83,0,2
옹장골,43230,93,2,93,2,0,3
옹진군청,37019,1335,2312,1333,2312,2,117
옹진군청,37020,7758,1066,7751,1066,7,284
완정공단입구,42409,5237,2951,5237,2951,0,264
완정사거리,42561,29083,7524,29049,7524,34,1180
완정사거리,42562,189,1939,187,1939,2,68
완정역,42673,11350,38036,11346,38036,4,1593
완정역,42674,8484,20203,8478,20203,6,925
완정초등학교.검단도서관,42414,2974,4410,2972,4410,2,238
완정초등학교.검단도서관,42415,2496,4908,2494,4908,2,238
왕궁가든,41289,1599,2266,1599,2266,0,124
왕궁가든,41291,1905,2912,1880,2912,25,155
왕길고가,42551,788,8,785,8,3,25
왕길고가,42552,0,753,0,753,0,24
왕길동,42386,25,358,24,358,1,12
왕길동,42387,192,175,188,175,4,11
왕길동(기점),42699,368,17,351,17,17,12
왕길동종점,42594,35,217,6,217,29,8
왕리물,90098,0,3,0,3,0,0
왕리물,90099,3,0,3,0,0,0
왕산골,35490,100,244,100,244,0,11
왕산골,35491,244,54,243,54,1,9
왕산교,35632,89,43,87,43,2,4
왕산교,35633,0,114,0,114,0,3
왕산차고지,35403,905,277,887,277,18,38
왕산차고지,35720,221,33,218,33,3,8
왕산해수욕장(왕산요트경기장),35020,1300,262,1295,262,5,50
왕산해수욕장(왕산요트경기장),35021,426,1013,423,1013,3,46
외1리마을회관앞,44096,31,52,29,52,2,2
외1리마을회관앞,44186,11,2,11,2,0,0
외1리소장골,44133,16,26,15,26,1,1
외뜰,43687,3,2,3,2,0,0
외뜰,43745,7,12,7,12,0,0
외리보건지소앞,44095,40,29,40,29,0,2
외리보건지소앞,44187,6,0,3,0,3,0
외주,43181,76,6,76,6,0,2
외주,43241,3,91,3,91,0,3
외포1리,43283,10,79,10,79,0,2
외포고개,43244,13,42,13,42,0,1
외포고개,43366,39,80,39,80,0,3
외포리,43556,1120,1214,1095,1214,25,75
외포리(싱싱마트),90376,44,5,36,5,8,1
외포리(하나로마트),90387,4,171,4,171,0,5
외포리(하나로마트),90388,96,29,96,29,0,4
외포리소공원,90127,7,9,6,9,1,0
외포리소공원,90128,0,39,0,39,0,1
외포리정미소,43240,98,4,98,4,0,3
외포삼거리,43110,304,127,299,127,5,13
외포삼거리,43285,17,122,17,122,0,4
요곡,43655,150,184,147,184,3,10
요곡,43762,92,31,92,31,0,3
요골,43590,52,1,51,1,1,1
요골,43780,1,8,1,8,0,0
용갈비,40338,82,2724,82,2724,0,90
용구물길,90385,0,34,0,34,0,1
용구물길,90386,10,0,10,0,0,0
용궁사입구,35578,240,983,239,983,1,39
용궁사입구,35579,878,89,869,89,9,31
용남시장,37232,16018,13213,15957,13213,61,942
용남시장,37236,15683,16881,15614,16881,69,1050
용남파출소,37177,7329,2486,7325,2486,4,316
용남파출소,37184,4365,10247,4358,10247,7,471
용담공원,38172,1422,2131,1422,2131,0,114
용담공원,38177,2423,1434,2417,1434,6,124
용담마을,38191,4266,5587,4234,5587,32,317
용담마을,38192,5026,2796,4981,2796,45,252
용담어촌계앞,44097,29,7,29,7,0,1
용담어촌계앞,44189,10,0,10,0,0,0
용당사터,43537,103,4,93,4,10,3
용당사터,43677,1,73,1,73,0,2
용유동행정복지센터,35017,54,41,54,41,0,3
용유동행정복지센터,35211,64,116,64,116,0,5
용유동행정복지센터,35411,253,256,253,256,0,16
용유동행정복지센터,35412,284,123,284,123,0,13
용유역,35433,302,1126,302,1126,0,46
용유초등학교,35022,260,24,251,24,9,9
용유초등학교,35023,51,251,51,251,0,9
용유초등학교,35409,89,561,89,561,0,20
용유초등학교삼거리,35410,456,47,456,47,0,16
용일사거리,37208,27526,20274,27499,20274,27,1541
용일사거리,37218,24715,27736,24662,27736,53,1691
용일사거리,37251,894,1206,894,1206,0,67
용일초등학교,37233,11238,7320,11211,7320,27,598
용일초등학교,37237,6583,15284,6535,15284,48,705
용정리 사거리,43721,1,134,1,134,0,4
용정마을회관,43370,1,40,1,40,0,1
용정마을회관,43615,263,0,257,0,6,8
용정초등학교,37297,1236,689,1236,689,0,62
용정초등학교,37299,647,1801,647,1801,0,78
용진주택,43084,225,72,215,72,10,9
용진주택,43085,6,29,6,29,0,1
용진진,43639,2,32,1,32,1,1
용진진,43678,29,15,26,15,3,1
용현2동행정복지센터,37653,1399,237,1399,237,0,52
용현2동행정복지센터,37654,337,1764,337,1764,0,67
용현3동행정복지센터.보훈병원,37221,24030,16881,23900,16881,130,1319
용현3동행정복지센터.보훈병원,37224,11942,14977,11896,14977,46,868
용현5동행정복지센터,37129,235,787,235,787,0,32
용현고가교,37550,162,2228,162,2228,0,77
용현고가교,37611,6902,1340,6897,1340,5,265
용현고개,37178,5889,6261,5888,6261,1,391
용현고개,37497,6969,6439,6966,6439,3,432
용현동농협,37117,419,2666,419,2666,0,99
용현동상우빌라,37564,3,615,3,615,0,19
용현동상우빌라,37565,1358,113,1337,113,21,47
용현동성원상떼빌아파트,37546,372,584,357,584,15,30
용현사거리,37212,2414,1710,2404,1710,10,133
용현사거리,37213,1501,3994,1478,3994,23,177
용현시장,37227,21699,26914,21628,26914,71,1568
용현시장,37230,23708,15010,23650,15010,58,1248
용현시장,37268,5507,3419,5473,3419,34,287
용현시장,37270,4187,5238,4163,5238,24,304
용현아파트,37153,24,300,24,300,0,10
용현중학교,37021,2590,496,2576,496,14,99
용현중학교,37028,839,2159,837,2159,2,96
용현초등학교,37508,1,745,1,745,0,24
용현초등학교입구,37128,9996,3670,9977,3670,19,440
용현초등학교입구,37134,6406,11754,6373,11754,33,585
용화사(길상낚시터),90077,10,50,10,50,0,1
용화사(길상낚시터),90080,36,33,36,33,0,2
우뢰촌,43425,132,48,131,48,1,5
우뢰촌,43792,93,89,92,89,1,5
우리자동차,35223,735,235,656,235,79,31
우림라이온스밸리,40592,368,4545,368,4545,0,158
우림라이온스밸리,40594,8283,1347,8275,1347,8,310
우림필유아파트,42924,3011,1363,3002,1363,9,141
우림필유아파트,42925,1041,2530,1041,2530,0,115
우물골,43929,57,36,57,36,0,3
우물골,43930,15,44,15,44,0,1
우미린1단지정문,35583,2624,674,2620,674,4,106
우미린1단지정문,35584,1068,2267,1066,2267,2,107
우미린1단지후문,35461,1476,3789,1475,3789,1,169
우미린1단지후문,35462,4155,795,4154,795,1,159
우미린2단지정문,35512,4665,1148,4659,1148,6,187
우미린2단지정문,35513,1903,5139,1902,5139,1,227
우미린2단지후문,35454,2769,911,2769,911,0,118
우미린더시그니처(후문),89443,3012,308,3012,308,0,107
우성1차아파트,38094,3718,4749,3717,4749,1,273
우성1차아파트,39834,862,27,839,27,23,28
우성2차아파트(옥련동),38356,2893,865,2893,865,0,121
우성2차아파트·원인재역(4번출구),38150,3024,7095,3012,7095,12,326
우성4차,40185,6274,212,6274,212,0,209
우성4차,40187,162,5778,162,5778,0,191
우성4차후문,40730,155,2345,155,2345,0,80
우성4차후문,40731,2918,212,2918,212,0,100
우성아파트,38143,4447,2170,4441,2170,6,213
우성아파트,38357,923,2184,918,2184,5,100
우성아파트,40341,965,1617,961,1617,4,83
우성아파트,42717,3296,6457,3296,6457,0,314
우성아파트,42718,2688,2162,2688,2162,0,156
우성아파트.은행교회,70026,405,25,403,25,2,13
우저서원(대성주유소),35214,119,96,119,96,0,6
우저서원(대성주유소),35215,98,782,98,782,0,28
우정아파트,37675,141,359,141,359,0,16
우주골드타운빌라,40863,729,1258,729,1258,0,64
우주골드타운빌라,40864,406,1019,406,1019,0,45
우주아파트,38252,5133,5499,5132,5499,1,342
우진기계,89106,8,320,5,320,3,10
우진아파트,37158,1355,1157,1347,1157,8,81
우진아파트,37159,287,2399,280,2399,7,86
우체국사거리,39694,923,1915,923,1915,0,91
우체국사거리,39695,1666,664,1666,664,0,75
우체국사거리,39704,2508,1942,2508,1942,0,143
욱일아파트후문,40877,1706,2321,1706,2321,0,129
운남교차로,35435,65,154,65,154,0,7
운남교차로,35444,166,134,166,134,0,9
운남교차로,35524,60,25,59,25,1,2
운남교차로,35582,19,23,18,23,1,1
운남교차로 입구,35839,26,72,19,72,7,3
운남교차로 입구,35840,16,42,15,42,1,1
운남교차로.잔다리,35595,487,254,483,254,4,23
운남교차로.잔다리,35596,220,513,220,513,0,23
운남동,35268,149,207,149,207,0,11
운남동,35281,262,255,262,255,0,16
운남동우체국,35848,378,187,377,187,1,18
운남동우체국,35849,237,438,237,438,0,21
운남초교사거리,35706,35,149,35,149,0,5
운남초교사거리,35707,406,175,405,175,1,18
운북공영차고지,35779,446,2,444,2,2,14
운북공영차고지,35783,1,557,1,557,0,18
운서2차SKVIEW스카이시티,35882,4017,1160,4015,1160,2,167
운서2차SKVIEW스카이시티,35883,1643,3625,1640,3625,3,169
운서SKVIEW 스카이시티,35780,47,183,47,183,0,7
운서SKVIEW·세계로향하는교회,35781,139,128,139,128,0,8
운서역,35242,28248,15317,28232,15317,16,1405
운서역,35257,8637,17667,8627,17667,10,848
운서역(남동측),35775,408,1047,408,1047,0,46
운서역(남동측),35776,1195,1109,1195,1109,0,74
운서역(하워드존슨호텔),35747,4779,4452,4779,4452,0,297
운서역금강펜테리움아파트,35482,1126,603,1126,603,0,55
운서역반도유보라,35878,2729,2349,2728,2349,1,163
운서역반도유보라,35879,1958,1911,1958,1911,0,124
운서초등학교,35270,6928,2072,6928,2072,0,290
운서초등학교,35282,2270,4239,2270,4239,0,209
운양역,80348,231,398,231,398,0,20
운양역,80351,288,143,287,143,1,13
운연동,39374,626,559,623,559,3,38
운연동,39379,467,524,467,524,0,31
운연동,39673,25,0,25,0,0,0
운연삼거리,39987,692,1431,689,1431,3,68
운연삼거리,39988,35,468,35,468,0,16
운연역,39954,10319,11171,10310,11171,9,693
운연역,92026,5970,6492,5969,6492,1,402
운연천,92027,259,874,259,874,0,36
운연천,92028,431,199,431,199,0,20
운전면허시험장,39005,3162,1170,3162,1170,0,139
울레기,43179,21,211,21,211,0,7
울레기,43548,231,18,216,18,15,8
웃말,90169,8,14,5,14,3,0
웃말,90170,10,5,10,5,0,0
원당고등학교,42459,1237,2417,1236,2417,1,117
원당교,89485,352,143,352,143,0,15
원당교,89486,68,1513,67,1513,1,51
원당사거리.검단선사박물관,42446,18398,8017,18375,8017,23,852
원당사거리.검단선사박물관,42447,10500,18145,10495,18145,5,924
원당중고등학교,42460,51,250,51,250,0,9
원당중고등학교,42462,159,217,159,217,0,12
원동초등학교,39656,1266,6649,1254,6649,12,255
원동초등학교,39657,9168,1516,9150,1516,18,344
원성골,35434,49,173,49,173,0,7
원성골,35445,69,230,69,230,0,9
원수리마을,90251,0,6,0,6,0,0
원수리마을,90252,8,2,8,2,0,0
원인재역(1번출구),38162,1556,6002,1550,6002,6,243
원인재역(4번출구),38153,10128,3026,10114,3026,14,424
원인재역(6번출구),38166,5755,2469,5752,2469,3,265
원적산터널,40821,1278,2896,1277,2896,1,134
원적산터널,40822,2091,3112,2091,3112,0,167
원적산터널서측,42666,4193,3521,4184,3521,9,248
원적산터널서측,42667,2999,3530,2997,3530,2,210
원종IC(중),57046,68,2937,68,2937,0,96
원종IC(중),57047,920,52,920,52,0,31
원진운수차고지,89003,855,115,850,115,5,31
원진운수차고지,89004,21,998,8,998,13,32
원창동(기점),89143,3309,37,3297,37,12,107
원창동(기점),89144,5,3138,5,3138,0,101
원창동(종점),42183,21,1171,20,1171,1,38
원창동(종점),42184,882,433,849,433,33,42
원흥아파트,38131,23294,14970,23239,14970,55,1234
원흥아파트,38336,32020,21940,31921,21940,99,1740
원흥아파트,42793,87,3,87,3,0,2
월곳삼거리,43188,0,54,0,54,0,1
월곳삼거리,43619,50,0,50,0,0,1
월곶동주민센터.월곶포구,70006,713,217,708,217,5,30
월곶동주민센터.월곶포구,70005,263,1444,259,1444,4,55
월곶어울림센터,25095,89,84,63,84,26,5
월드메르디앙아파트,42161,3653,4300,3614,4300,39,256
월드메르디앙아파트,42163,5510,3071,5496,3071,14,276
월드아파트,42499,6879,8804,6873,8804,6,505
월드아파트,42500,11476,5442,11472,5442,4,545
월미공원,35138,19,539,19,539,0,18
월미공원,35572,112,11,112,11,0,3
월미공원역,35345,76,2435,74,2435,2,81
월미공원역,35346,3358,184,3348,184,10,114
월미도,35148,25481,161,25292,161,189,827
월미도(시티투어),35144,447,11237,430,11237,17,376
월미도문화관,35558,1626,39,1620,39,6,53
월미도종점,35368,136,6204,112,6204,24,204
월미문화의거리,35132,18,3500,18,3500,0,113
월미문화의거리,35219,2422,14,2422,14,0,78
월미테마파크,35128,59,7254,59,7254,0,235
월미테마파크,35502,3786,39,3786,39,0,123
월선포,90041,61,46,54,46,7,3
웨딩타운,22061,182,0,182,0,0,5
웨딩타운,23077,0,23,0,23,0,0
웰카운티,38352,1258,5244,1258,5244,0,209
웰카운티,38353,9298,1263,9298,1263,0,340
웰카운티,42772,1693,3872,1685,3872,8,179
웰카운티17단지,89182,3132,868,3132,868,0,129
웰카운티17단지,89183,320,2676,320,2676,0,96
웰카운티1단지,38648,1016,3042,1016,3042,0,130
웰카운티1차,42746,1913,1487,1913,1487,0,109
웰카운티1차,42764,2403,1227,2403,1227,0,117
웰카운티2단지,38709,860,737,858,737,2,51
웰카운티4단지,38446,323,364,322,364,1,22
웰카운티4단지,38447,212,942,212,942,0,37
윗말,43488,11,5,11,5,0,0
윗말,43839,5,9,5,9,0,0
윗망월,43335,5,87,5,87,0,2
윗망월,43578,141,3,124,3,17,4
유니온프라자,42113,12206,7524,12150,7524,56,636
유림골프장,41469,6,973,6,973,0,31
유림골프장,41667,811,2,811,2,0,26
유성아파트,43086,165,699,163,699,2,27
유성아파트,43087,652,81,645,81,7,23
유수지,39010,505,980,505,980,0,47
유수지,39011,720,1905,719,1905,1,84
유수지근린공원,39019,1182,977,1182,977,0,69
유수지근린공원,39020,762,1038,762,1038,0,58
유수지길,39003,1258,2165,1256,2165,2,110
유수지길,39004,1554,1030,1554,1030,0,83
유승아파트,42397,2597,546,2588,546,9,101
유승아파트,42398,528,2547,527,2547,1,99
유승아파트(삼성홈타운아파트),41003,3464,3192,3460,3192,4,214
유승아파트(삼성홈타운아파트),41004,3094,3384,3087,3384,7,208
유승아파트(삼성홈타운아파트),41005,5883,2002,5865,2002,18,254
유승아파트(삼성홈타운아파트),41006,1571,6035,1550,6035,21,245
유승아파트(삼성홈타운아파트),41583,4,287,4,287,0,9
유승한내들에듀파크,89520,27,136,27,136,0,5
유원아파트,37163,5783,9695,5755,9695,28,499
유원아파트,37172,11966,4514,11938,4514,28,531
유진시스템앞,40676,929,4370,929,4370,0,170
유진시스템앞,40678,1736,1069,1736,1069,0,90
유진투자증권.파이낸셜뉴스신문,19283,1002,40,1002,40,0,33
유천아파트,38254,1001,687,1001,687,0,54
유천아파트,38266,7053,5045,7053,5045,0,390
유천아파트후문,38265,317,1069,317,1069,0,44
유현마을.신동아아파트,80001,187,316,187,316,0,16
유현마을.신동아아파트,80073,315,25,315,25,0,10
유현사거리,42484,7030,11476,7020,11476,10,596
유현사거리,42487,7056,5824,7052,5824,4,415
유호엔시티.논현푸르지오,39823,49,1893,45,1893,4,62
육골,18805,0,80,0,80,0,2
육골,62030,10,3,6,3,4,0
윤성아파트,38307,232,1457,232,1457,0,54
윤성아파트(인항고교),37011,2346,3540,2340,3540,6,189
윤성아파트(인항고교),37012,3034,1867,3027,1867,7,158
율도근린공원,89339,347,128,347,128,0,15
율도근린공원,89340,409,510,409,510,0,29
율도근린공원입구,89428,291,281,291,281,0,18
율도근린공원입구,89429,208,151,208,151,0,11
율도입구,42188,1046,1066,1046,1066,0,68
율도입구,42190,889,703,887,703,2,51
율목동행정복지센터,35787,20,149,20,149,0,5
율목동행정복지센터,35801,89,32,89,32,0,3
율목오거리,35786,18,55,18,55,0,2
율목오거리,35802,68,32,68,32,0,3
율생리입구,80016,218,1170,218,1170,0,44
율생리입구,80017,1120,203,1113,203,7,42
은계초등학교.사랑스러운교회,70025,1327,24,1316,24,11,43
은골공원,35599,1559,2517,1555,2517,4,131
은골공원,35600,1977,2423,1970,2423,7,141
은골사거리,35309,218,245,218,245,0,14
은당골,90212,14,13,14,13,0,0
은당골,90213,17,14,15,14,2,1
은봉초등학교,39613,9148,2433,9131,2433,17,373
은봉초등학교,39614,1980,10875,1966,10875,14,414
은성아파트,39321,7011,2954,6993,2954,18,321
은성프레미오,39325,1482,4873,1479,4873,3,205
은영빌라,41089,2067,78,2067,78,0,69
은영아파트,42218,3165,2832,3153,2832,12,193
은지초등학교사거리,42365,5290,6084,5285,6084,5,366
은하마을.중흥마을,55069,381,1526,381,1526,0,61
은하목장앞,43274,0,4,0,4,0,0
은하목장앞,43852,0,11,0,11,0,0
은하쌍용아파트,55062,1131,5170,1131,5170,0,203
은행마을,41198,6972,2872,6952,2872,20,317
은행초등학교,70019,2965,398,2948,398,17,108
을왕리해수욕장,35009,5901,799,5901,799,0,216
을왕리해수욕장,35010,1822,5933,1818,5933,4,250
을왕리해수욕장.더위크앤리조트,35015,3429,695,3428,695,1,133
을왕리해수욕장.더위크앤리조트,35016,1051,2769,1049,2769,2,123
읍내리마을회관입구,90032,0,28,0,28,0,0
읍내리마을회관입구,90033,37,1,33,1,4,1
응곡,43696,19,54,18,54,1,2
응곡,43749,61,27,61,27,0,2
이강리방앗간,43691,108,14,103,14,5,3
이강리방앗간,43832,26,214,26,214,0,7
이건창생가,43145,51,8,51,8,0,1
이건창생가,43434,0,95,0,95,0,3
이규보묘입구,90065,131,17,131,17,0,4
이규보묘입구,90389,10,120,10,120,0,4
이대역,22015,3549,55,3549,55,0,116
이대역,22057,2246,26,2246,26,0,73
이대역,23036,73,4682,73,4682,0,153
이마트,41122,3941,16691,3927,16691,14,665
이마트,41125,25120,8533,25082,8533,38,1085
이마트송림점,36098,5536,7721,5525,7721,11,427
이마트송림점,36100,7557,4748,7547,4748,10,396
이안송도,38409,23590,7721,23590,7721,0,1010
이영화학,39644,2441,1053,2441,1053,0,112
이음1로.모아미래도엘리트파크,89514,1014,1027,1014,1027,0,65
이음1로.예미지더시그너스,89513,2807,1600,2807,1600,0,142
이음2로.디에트르더펠리체,89509,1397,136,1397,136,0,49
이음2로.파라곤센트럴파크,89510,245,1772,245,1772,0,65
이음5로.금호어울림센트럴,89433,1214,5804,1214,5804,0,226
이음5로.우미린더시그니처,89432,4693,2193,4693,2193,0,222
이음대로.대성베르힐,89440,17318,2358,17313,2358,5,634
이음대로.대성베르힐,89441,3198,25102,3198,25102,0,912
이음대로.디에트르더펠리체,89438,8821,1887,8821,1887,0,345
이음대로.호반써밋,89439,4121,11981,4106,11981,15,519
이촌,43312,0,3,0,3,0,0
이촌,43768,30,1,30,1,0,1
이토상가,39196,8476,2121,8454,2121,22,341
이현(이강리교회),43661,5,179,5,179,0,5
이현(이강리교회),43690,177,2,163,2,14,5
이화1동입구,41487,135,93,128,93,7,7
이화1동입구,41506,32,3,31,3,1,1
이화2동마을회관,41484,20,23,20,23,0,1
이화2동마을회관,41504,70,49,70,49,0,3
이화2동회차지,41486,6,8,6,8,0,0
이화교회앞,41489,40,42,40,42,0,2
이화동노인정,41490,79,34,79,34,0,3
이화동다리,41479,78,297,78,297,0,12
이화동다리,41516,361,30,361,30,0,12
이화진등마을경로당,41601,24,48,24,48,0,2
인고앞,37318,2327,4687,2320,4687,7,226
인고앞,37338,5822,3311,5807,3311,15,294
인고체육관,37305,8869,4484,8857,4484,12,430
인고체육관(동양장사거리),37309,4400,6689,4387,6689,13,357
인내마을,90181,5,19,5,19,0,0
인내마을,90182,8,4,8,4,0,0
인명여자고등학교,37199,26503,3027,26495,3027,8,952
인명여자고등학교,37205,6859,39466,6852,39466,7,1494
인사리군부대앞,90268,17,44,17,44,0,1
인사리군부대앞,90270,25,1,25,1,0,0
인사리마을회관,90267,0,16,0,16,0,0
인사리마을회관,90271,20,0,20,0,0,0
인사리우무렛골,90266,10,33,10,33,0,1
인사리인현경로당앞,90269,32,20,32,20,0,1
인사리지석교회,90272,5,2,5,2,0,0
인산저수지,43354,124,82,122,82,2,6
인산저수지,43575,88,112,87,112,1,6
인삼농협앞,80305,14,292,14,292,0,9
인삼농협앞,80306,362,9,361,9,1,11
인성여자고등학교,35793,100,383,100,383,0,15
인성여자고등학교,35808,46,350,46,350,0,12
인송빌라,40241,2428,21,2428,21,0,79
인수초등학교,39386,10178,9668,10173,9668,5,640
인수초등학교,39392,13097,12127,13092,12127,5,813
인썸호텔,44134,44,16,34,16,10,1
인아교회,35091,975,184,975,184,0,37
인아교회,35094,209,932,209,932,0,36
인재개발원,42281,1225,2128,1223,2128,2,108
인재개발원,42282,2102,1172,2092,1172,10,105
인제고등학교,39548,437,1181,434,1181,3,52
인천가정법원.인천지방법원등기국,37405,9908,12535,9881,12535,27,723
인천가정법원.인천지방법원등기국,37409,22787,21100,22741,21100,46,1415
인천가족공원입구,39493,657,546,657,546,0,38
인천가족공원입구,39495,933,1615,932,1615,1,82
인천가족공원입구,92059,1529,1210,1525,1210,4,88
인천가톨릭대학교,39931,2667,1555,2667,1555,0,136
인천가톨릭대학교(카펠라관),38778,1,0,1,0,0,0
인천경로당앞,90226,15,14,15,14,0,0
인천경로당앞,90227,15,5,15,5,0,0
인천경연초중학교,89347,35,246,35,246,0,9
인천공항T1(1층13B),35205,35268,402,35216,402,52,1150
인천공항T1(1층2A),35344,49256,2772,49185,2772,71,1678
인천공항T1(1층2B),35202,18208,5677,18208,5677,0,770
인천공항T1(3층13번),35556,2161,20843,2143,20843,18,742
인천공항T1(3층14번),35753,3767,7404,3761,7404,6,360
인천공항T1(3층2번),35032,3520,48011,3520,48011,0,1662
인천공항T1(3층6번),35752,10448,20753,10447,20753,1,1006
인천공항T1(3층7번),35203,10522,54472,10514,54472,8,2096
인천공항T1-3층,35325,17,31,17,31,0,1
인천공항T2(1)A(1층),35618,19014,57,19014,57,0,615
인천공항T2(1)번출입구(3층),35614,7156,32597,7156,32597,0,1282
인천공항T2(6)B(1층),35619,5242,147,5242,147,0,173
인천공항T2(8)번출입구(3층),35615,9458,7069,9457,7069,1,533
인천공항T2-3층,35611,47,36,47,36,0,2
인천공항T2-B1층,35612,214,1,214,1,0,6
인천공항전망대,35365,2,70,2,70,0,2
인천공항전망대,35366,72,11,72,11,0,2
인천공항전망대(미정차),35630,4,1,4,1,0,0
인천공항충전소입구,35757,10,41,10,41,0,1
인천공항충전소입구,35758,44,2,44,2,0,1
인천과학예술영재학교,38579,121,102,117,102,4,7
인천과학예술영재학교,38580,16,411,16,411,0,13
인천광역시종합건설본부,37325,6417,5691,6412,5691,5,390
인천교(인천기계산업단지),37449,1353,834,1348,834,5,70
인천교(인천기계산업단지),37451,303,1455,301,1455,2,56
인천교삼거리,37453,1829,4075,1808,4075,21,190
인천교삼거리(인천기계산업단지),37452,1542,1193,1534,1193,8,88
인천교통공사,40032,35952,32697,35851,32697,101,2214
인천교회,38676,2586,5207,2581,5207,5,251
인천교회,39260,2727,3485,2715,3485,12,200
인천교회,39261,3269,2469,3253,2469,16,185
인천국민안전체험관,42233,134,423,134,423,0,17
인천국민안전체험관,42234,1134,856,1127,856,7,64
인천국제공항,35613,9,0,9,0,0,0
인천국제수산물타운,35815,9,1391,9,1391,0,45
인천국제수산물타운,35816,617,63,606,63,11,21
인천그랜드컨트리클럽,42954,125,796,125,796,0,29
인천그랜드컨트리클럽,42958,5,47,5,47,0,1
인천글로벌캠퍼스,39850,1583,1888,1583,1888,0,111
인천글로벌캠퍼스,39858,1607,1386,1607,1386,0,96
인천기계공고,37272,16880,5925,16879,5925,1,735
인천기계공고,37281,3546,11346,3546,11346,0,480
인천기계산업단지,37579,679,27,679,27,0,22
인천기계산업단지,37580,2,720,2,720,0,23
인천기독병원,35785,279,446,279,446,0,23
인천기독병원,35803,67,189,67,189,0,8
인천나비공원,40849,3796,2192,3728,2192,68,193
인천나비공원,40926,20,0,19,0,1,0
인천남동우체국,39630,7819,7464,7811,7464,8,493
인천남부초.힐스테이트푸르지오,37275,12301,14395,12245,14395,56,861
인천노인전문병원,40878,3760,5915,3760,5915,0,312
인천논현역앞,39658,12574,16628,12570,16628,4,942
인천논현역앞,39659,13558,8994,13540,8994,18,727
인천논현중학교,92060,47,991,45,991,2,33
인천논현중학교,92061,145,107,139,107,6,8
인천논현중학교,92062,357,69,352,69,5,13
인천대검도수련원,43456,2,47,2,47,0,1
인천대검도수련원,43695,65,2,65,2,0,2
인천대공원,39471,2574,655,2571,655,3,104
인천대공원,39478,2560,5247,2559,5247,1,251
인천대공원역,39395,6957,1857,6949,1857,8,284
인천대공원역,39398,70,2093,70,2093,0,69
인천대공원후문(장수동),39442,3971,630,3933,630,38,148
인천대교TG(미정차),35629,0,1,0,1,0,0
인천대입구역,38395,37342,16295,37322,16295,20,1730
인천대입구역,38396,14850,32657,14828,32657,22,1532
인천대입구역.롯데몰,38646,4946,3859,4946,3859,0,284
인천대입구역.롯데몰,38649,2280,2544,2275,2544,5,155
인천대정문,38385,7160,367,7152,367,8,242
인천대정문,38386,670,7679,669,7679,1,269
인천대학교공과대학,38376,203,3263,203,3263,0,111
인천대학교공과대학,38377,10259,15,10213,15,46,331
인천대학교공과대학,38499,450,8912,406,8912,44,302
인천대학교북문,38760,1,812,1,812,0,26
인천대학교북문,38750,220,50,216,50,4,8
인천대학교송도캠퍼스,38749,11487,2111,11483,2111,4,438
인천대학교송도캠퍼스,38761,6,5686,6,5686,0,183
인천대학교자연과학대학,38375,113,7644,113,7644,0,250
인천대학교자연과학대학,38378,8024,40,8022,40,2,260
인천마전도서관,42556,8,1210,7,1210,1,39
인천만수고등학교,39680,548,681,548,681,0,39
인천만수고등학교,39681,361,1213,361,1213,0,50
인천미래생활고등학교,40470,3602,3880,3602,3880,0,241
인천미래생활고등학교,40474,4202,4550,4202,4550,0,282
인천미래생활고등학교,40483,569,1266,569,1266,0,59
인천미래생활고등학교,55032,2054,1166,2054,1166,0,103
인천박문초등학교,38608,349,117,349,117,0,15
인천박문초등학교,38609,92,426,92,426,0,16
인천보건고등학교,42144,2074,3646,2055,3646,19,184
인천보건고등학교,42146,4434,3779,4379,3779,55,264
인천부흥고등학교,40279,1417,483,1417,483,0,61
인천북항관공선부두,89195,52,1345,52,1345,0,45
인천북항관공선부두,89196,770,25,770,25,0,25
인천북항부두운영시설,42953,8,409,8,409,0,13
인천북항부두운영시설,42959,511,26,511,26,0,17
인천뷰티예술고등학교,38052,2132,2824,2119,2824,13,159
인천뷰티예술고등학교,38053,5000,2633,4996,2633,4,246
인천비즈니스고등학교,37421,3433,3020,3427,3020,6,208
인천비즈니스고등학교,37423,4382,4543,4374,4543,8,287
인천비즈니스고등학교,37614,6791,2021,6782,2021,9,284
인천비지니스고등학교,37615,369,2034,369,2034,0,77
인천상공회의소,92041,100,0,100,0,0,3
인천서곶초등학교,89355,266,2,260,2,6,8
인천서곶초등학교,89358,3,627,3,627,0,20
인천서부교육지원청,42336,804,318,804,318,0,36
인천서부교육지원청,42337,283,1390,283,1390,0,53
인천서부여성회관,42131,2454,1416,2425,1416,29,124
인천서부여성회관,42134,3900,4854,3872,4854,28,282
인천서창동우체국,39820,5088,9056,5082,9056,6,456
인천서창동우체국,39821,8570,2329,8554,2329,16,351
인천서창중학교,39767,5003,5153,5003,5153,0,327
인천서창중학교,39875,7347,2771,7347,2771,0,326
인천성모병원정문,40844,8607,9176,8572,9176,35,573
인천성모병원정문,40857,9897,7588,9877,7588,20,564
인천성모병원종점지주차장,40919,248,4819,246,4819,2,163
인천성모병원후문,40138,1970,8044,1954,8044,16,323
인천성모병원후문,40139,5102,2257,5081,2257,21,237
인천세관통합검사센터(동측),38774,2,1224,2,1224,0,39
인천세관통합검사센터(동측),38775,59,38,59,38,0,3
인천세관통합검사센터(서측),38772,124,358,119,358,5,15
인천세관통합검사센터(서측),38773,18,541,17,541,1,18
인천세무서후문,36179,19,219,19,219,0,7
인천소방본부,37189,5311,8846,5296,8846,15,456
인천소방본부,37191,12813,5457,12778,5457,35,589
인천소방항공대,35809,128,6,127,6,1,4
인천소방항공대,35810,6,200,6,200,0,6
인천송도꿈유치원,38622,3577,48,3577,48,0,116
인천송도꿈유치원,38623,11,5557,11,5557,0,179
인천송일초등학교,38558,525,1415,522,1415,3,62
인천송일초등학교,38575,1265,1439,1259,1439,6,87
인천수산물센터,35069,6948,6734,6868,6734,80,441
인천스타트업파크,38390,2333,864,2329,864,4,103
인천스타트업파크,38394,993,2964,989,2964,4,127
인천시청후문,39290,11905,8444,11881,8444,24,656
인천시청후문,39292,10546,11670,10510,11670,36,716
인천아시아드주경기장(동문),89354,638,13,604,13,34,21
인천아시아드주경기장(동문),89359,84,801,82,801,2,28
인천아시아드테니스장,89356,389,20,385,20,4,13
인천아시아드테니스장,89357,9,745,9,745,0,24
인천여객터미널,89155,1,220,1,220,0,7
인천여자고등학교,38287,3583,6303,3583,6303,0,318
인천여자고등학교,38289,1954,2403,1954,2403,0,140
인천여자상업고등학교,35139,316,2212,314,2212,2,81
인천여자상업고등학교·이마트,35141,8346,2390,8324,2390,22,346
인천역(차이나타운),35178,24392,21597,24337,21597,55,1483
인천역(차이나타운),35179,23822,23594,23749,23594,73,1529
인천연세병원,42310,2180,2641,2180,2641,0,155
인천연합의원,42601,2089,3532,2080,3532,9,181
인천영어마을,42454,9030,8422,9010,8422,20,562
인천영어마을,42697,9812,13887,9796,13887,16,764
인천영어마을.파라곤센트럴,89437,6892,1678,6882,1678,10,276
인천영어마을앞,89436,252,1121,209,1121,43,44
인천예림학교(인천성모병원),40819,4777,6140,4757,6140,20,352
인천예림학교(인천성모병원),40820,6812,3723,6804,3723,8,339
인천예술고등학교,39332,854,525,843,525,11,44
인천예술고등학교,39533,505,649,498,649,7,37
인천옹진농협본점,35555,6087,4118,6063,4118,24,329
인천옹진농협본점,35797,888,1700,886,1700,2,83
인천용학초등학교,37676,2605,21,2605,21,0,84
인천의료원,36093,536,4472,536,4472,0,161
인천의료원,36107,14905,8653,14879,8653,26,759
인천의료원,36108,8823,12451,8799,12451,24,686
인천의료원,37458,4773,908,4773,908,0,183
인천이음중학교,89456,2518,713,2518,713,0,104
인천이음초등학교,89399,2706,767,2706,767,0,112
인천이음초등학교,89400,2888,7735,2888,7735,0,342
인천인력개발원,39071,1610,762,1608,762,2,76
인천인력개발원,39072,629,1928,627,1928,2,82
인천재능대학교서문,36058,11921,20747,11881,20747,40,1053
인천재능대학교서문,36119,8892,7979,8863,7979,29,544
인천적십자병원(풍림아파트),38240,3288,4665,3273,4665,15,256
인천적십자병원(풍림아파트),38339,5455,4283,5444,4283,11,314
인천정보과학고등학교,35175,1958,2487,1958,2487,0,143
인천정보과학고등학교,35183,3171,1351,3137,1351,34,145
인천정보과학고등학교,35800,5,20,5,20,0,0
인천정보과학고등학교,36002,1270,2704,1267,2704,3,128
인천종합수산물센터,35074,3180,264,3090,264,90,111
인천준법지원센터·미추홀트루엘파크,37147,966,346,966,346,0,42
인천준법지원센터·미추홀트루엘파크,37148,212,1020,212,1020,0,39
인천지방법원,37096,4513,63,4438,63,75,147
인천지방법원북부지원입구,89434,859,832,859,832,0,54
인천지방법원북부지원입구,89435,77,2109,77,2109,0,70
인천지방중소기업청입구,39087,2916,1063,2915,1063,1,128
인천체육고등학교,89233,273,256,273,256,0,17
인천체육고등학교입구,89048,34,14,34,14,0,1
인천체육고등학교입구,89049,4,60,3,60,1,2
인천축구전용경기장,36184,27,14,27,14,0,1
인천축구전용경기장,37286,2276,2225,2264,2225,12,145
인천축구전용경기장,37303,3507,1623,3492,1623,15,165
인천축구전용경기장(홈플러스),37558,503,2343,499,2343,4,91
인천축산농협,40454,352,881,347,881,5,39
인천축산물시장,42010,1541,1070,1534,1070,7,84
인천축산물시장,42011,765,1512,765,1512,0,73
인천출입국·외국인청,35127,15244,1762,15206,1762,38,548
인천출입국·외국인청,35129,1110,12993,1096,12993,14,454
인천터미널,37215,1786,25,1786,25,0,58
인천터미널사거리입구,39194,1226,5448,1226,5448,0,215
인천터미널역,37648,561,37,555,37,6,19
인천테크노밸리U1센터,40605,6430,8501,6428,8501,2,481
인천테크노밸리U1센터,40607,10269,6047,10266,6047,3,526
인천포스코고등학교,38758,12,755,12,755,0,24
인천포스코고등학교,38759,434,6,434,6,0,14
인천푸른빛유치원,89376,1667,68,1667,68,0,55
인천푸른빛유치원,89377,156,1567,156,1567,0,55
인천항신국제여객터미널,38652,1668,572,1661,572,7,72
인천항신국제여객터미널(하행),38662,796,1257,794,1257,2,66
인천해든초등학교,89410,4936,2901,4936,2901,0,252
인천해든초등학교,89411,4055,3342,4055,3342,0,238
인천해양과학고,38120,1308,1120,1308,1120,0,78
인천해양과학고,38566,290,485,283,485,7,25
인천향교.인천도호부청사,37124,3499,10638,3495,10638,4,456
인천향교.인천도호부청사,37125,7408,1282,7359,1282,49,280
인천향교유림회관,37059,12790,4091,12776,4091,14,544
인천향교유림회관,37062,8083,13606,8073,13606,10,699
인천환경공단입구,42930,328,127,324,127,4,14
인천힘찬종합병원,39628,5558,3817,5554,3817,4,302
인천힘찬종합병원,39629,4258,4582,4256,4582,2,285
인평자동차고,40149,14631,17229,14599,17229,32,1027
인평자동차고,40151,808,463,808,463,0,41
인평자동차고,40152,244,769,244,769,0,32
인평자동차고,40787,17271,11236,17256,11236,15,919
인하국제의료센터,35643,0,7,0,7,0,0
인하대병원,35119,13657,9297,13618,9297,39,740
인하대병원,35121,3916,1592,3898,1592,18,177
인하대병원,35486,6832,7578,6832,7578,0,464
인하대병원입구,35846,6919,14079,6876,14079,43,677
인하대역,37596,10,8147,10,8147,0,263
인하대역(1번출구),37066,68530,71572,68412,71572,118,4519
인하대역(7번출구),37091,95955,65486,95885,65486,70,5207
인하대역3번출구,37127,3494,18338,3492,18338,2,704
인하대역4번출구,37122,12585,4965,12575,4965,10,566
인하대정문,37099,9569,5987,9553,5987,16,501
인하대정문,37104,5234,12815,5223,12815,11,582
인하대후문,37165,30667,4048,30667,4048,0,1119
인하대후문,37166,607,1326,607,1326,0,62
인하대후문,37167,10293,36223,10286,36223,7,1500
인향아파트,40557,7157,429,7120,429,37,244
인향아파트,40559,423,6061,417,6061,6,209
인향아파트,41464,2572,97,2560,97,12,86
인향아파트,41465,40,5814,24,5814,16,188
인혜학교후문(원욱그린타운),41473,1039,660,1037,660,2,54
인혜학교후문(원욱그린타운),41518,560,2414,557,2414,3,95
인화1리마을회관,90210,12,13,12,13,0,0
인화1리마을회관,90211,11,12,10,12,1,0
인화리종점,43473,48,29,45,29,3,2
인화성입구,90063,0,25,0,25,0,0
인화성입구,90064,14,0,14,0,0,0
인화여고,37547,2657,4092,2644,4092,13,217
인화여고,37548,7773,10800,7763,10800,10,599
일신동행정복지센터,40200,5910,3440,5890,3440,20,301
일신동행정복지센터,40205,94,1498,94,1498,0,51
일신동행정복지센터,40220,2649,2735,2640,2735,9,173
일신시장,40207,3547,4428,3540,4428,7,257
일신시장,40210,4221,2157,4200,2157,21,205
일신주공,40866,526,952,522,952,4,47
일신주공109동,40868,5863,3912,5851,3912,12,315
임광그대가.서창자이아파트,39514,3217,1552,3217,1552,0,153
임광그대가.서창자이아파트,39515,250,3421,248,3421,2,118
임광그대가103동,92025,3522,3262,3509,3262,13,218
임송촌,43423,8,3,8,3,0,0
임송촌,43802,67,78,67,78,0,4
임학사거리,41283,474,1839,464,1839,10,74
임학역,41290,13872,20621,13856,20621,16,1112
임학역,41292,22257,13032,22209,13032,48,1138
임학지하차도앞사거리,41287,16,3380,16,3380,0,109
임학지하차도앞사거리,41288,2497,7,2497,7,0,80
입구지,35300,32,4,32,4,0,1
입구지,35751,2,18,2,18,0,0
입구지입구,35477,59,74,56,74,3,4
입구지입구,35478,52,20,49,20,3,2
자동차매매단지,11020,248,577,248,577,0,26
자동차매매단지,11021,451,291,448,291,3,23
자동차매매단지,36094,318,5543,312,5543,6,189
자동차매매단지,37459,4279,355,4279,355,0,149
자연사박물관,43667,2,20,2,20,0,0
자이금호힐스테이트,42849,367,3948,365,3948,2,139
자이금호힐스테이트,42850,3326,397,3317,397,9,120
자이더테라스1단지,89297,1270,414,1270,414,0,54
자이더테라스1단지,89298,524,1317,521,1317,3,59
자이더테라스2단지,42864,1836,2894,1836,2894,0,152
자이더테라스2단지,42871,3261,1332,3261,1332,0,148
자이더테라스2단지(209동),89460,486,873,486,873,0,43
자이더테라스2단지(209동),89495,88,516,88,516,0,19
작은구월사거리,39239,4838,5524,4836,5524,2,334
작은구월사거리,39240,6123,5938,6096,5938,27,389
작전1동주민센터,41113,14174,8344,14162,8344,12,726
작전동삼성홈플러스,41044,15292,26689,15241,26689,51,1354
작전동삼성홈플러스,41050,18229,8593,18106,8593,123,865
작전동풍림아파트,41090,185,1060,185,1060,0,40
작전서운동행정복지센터,41103,434,2514,434,2514,0,95
작전서운동행정복지센터,41104,2424,423,2411,423,13,91
작전역,41561,7411,6300,7411,6300,0,442
작전역,41562,6846,7115,6846,7115,0,450
작전역 서해그랑블,41047,2354,2391,2347,2391,7,153
작전역 서해그랑블,41414,1135,3153,1135,3153,0,138
작전역1번출구,41095,10491,14875,10481,14875,10,818
작전역2번출구,41092,5315,6904,5315,6904,0,394
작전역3번출구,41076,9070,4316,9061,4316,9,431
작전역4번출구,41062,14587,30297,14529,30297,58,1447
작전역5번출구,41057,56729,32606,56631,32606,98,2881
작전역6번출구,41433,3970,25203,3970,25203,0,941
작전역7번출구,41401,21845,5650,21837,5650,8,886
작전역8번출구,41093,10546,8862,10531,8862,15,626
작전중고.여고앞,41116,2939,2385,2915,2385,24,171
작전초등학교,41127,2867,2575,2855,2575,12,175
작전초등학교,41128,2448,2368,2432,2368,16,155
작전풍림아파트,41080,1043,5890,1043,5890,0,223
작전풍림아파트,41091,7653,2852,7634,2852,19,338
잔다리삼거리,35519,73,48,70,48,3,3
잔다리삼거리,35559,95,48,95,48,0,4
잔다리삼거리,35856,8,22,8,22,0,0
잔다리삼거리,35857,11,4,11,4,0,0
잔다리새마을,35866,19,91,19,91,0,3
잔다리새마을,35867,49,96,49,96,0,4
잔솔밭,43943,43,15,39,15,4,1
잔솔밭,43944,20,19,17,19,3,1
잠진도삼거리,35743,41,2,41,2,0,1
잠진도삼거리,35744,0,91,0,91,0,2
잠진도입구,35749,1,75,1,75,0,2
잠진도입구,35750,62,22,58,22,4,2
장경리공영주차장,44141,2,23,2,23,0,0
장경리공영주차장,44190,38,0,37,0,1,1
장경리해수욕장,44092,12,16,12,16,0,0
장경리해수욕장,44191,9,2,9,2,0,0
장곡.고촌고등학교,80066,137,61,137,61,0,6
장곡.고촌고등학교,80288,7,32,7,32,0,1
장곶돈대,43931,79,25,77,25,2,3
장곶돈대,43932,16,60,15,60,1,2
장곶횟집,43118,10,8,10,8,0,0
장곶횟집,43478,10,11,10,11,0,0
장구란,90349,1,2,1,2,0,0
장구란,90354,1,2,1,2,0,0
장기동,41345,682,167,682,167,0,27
장기동,41346,238,2695,238,2695,0,94
장기동,41347,2613,12673,2610,12673,3,493
장기동,41348,17088,3242,17041,3242,47,655
장도초등학교,39127,344,533,344,533,0,28
장도초등학교,39129,2106,718,2106,718,0,91
장릉입구,80046,17,205,17,205,0,7
장릉입구,80047,250,6,250,6,0,8
장미아파트,37044,6474,8564,6471,8564,3,485
장미아파트,37092,11771,7578,11710,7578,61,624
장미아파트,37094,6243,7271,6220,7271,23,435
장미아파트(19동)앞,37474,1185,1958,1185,1958,0,101
장미아파트(19동)앞,37540,1558,1781,1549,1781,9,107
장서초등학교,39965,3587,754,3584,754,3,140
장서초등학교,39966,971,5188,971,5188,0,198
장수.서창동행정복지센터,39580,4505,7874,4502,7874,3,399
장수.서창동행정복지센터,39581,7918,1955,7916,1955,2,318
장수공영차고지,39566,1159,259,1012,259,147,45
장수공영차고지,92064,241,154,11,154,230,12
장수교,39336,353,425,353,425,0,25
장수교(서창동입구),39337,207,899,207,899,0,35
장수동,39373,457,1467,454,1467,3,62
장수동,39391,796,715,793,715,3,48
장수동,39393,2750,4110,2748,4110,2,221
장수빌라,39577,426,1091,426,1091,0,48
장수사거리,39389,10980,2634,10956,2634,24,439
장수사거리,39397,216,2363,216,2363,0,83
장수사거리,39501,2120,6932,2116,6932,4,292
장수사거리,39542,4681,348,4670,348,11,162
장수주공(청소년수련원),39417,39,1977,39,1977,0,65
장수주공(청소년수련원),39424,2931,46,2922,46,9,96
장수초등학교,39342,2295,1483,2273,1483,22,121
장수초등학교,39352,755,1978,753,1978,2,88
장수파출소,39543,23,662,23,662,0,22
장승마루,90028,1,12,1,12,0,0
장승마루,90029,15,0,15,0,0,0
장승마을,43200,0,41,0,41,0,1
장승마을,43714,60,0,50,0,10,1
장승백이시장,39280,3809,1535,3790,1535,19,172
장승백이시장,39282,569,3855,563,3855,6,142
장아초등학교,39873,803,549,801,549,2,43
장아초등학교,39874,140,1500,139,1500,1,52
장안,43418,11,33,9,33,2,1
장안,43445,55,10,53,10,2,2
장안마을,43133,12,0,11,0,1,0
장안마을,43855,0,7,0,7,0,0
장안말(구초지분교)입구,90083,66,100,66,100,0,5
장안말(구초지분교)입구,90084,91,151,91,151,0,7
장안말(온천스파),43144,30,12,30,12,0,1
장안말(온천스파),43253,47,1,46,1,1,1
장안말(온천스파),43892,8,2,8,2,0,0
장안사거리,37285,15805,3556,15789,3556,16,624
장안사거리,37295,4561,18044,4555,18044,6,729
장안촌동쪽,43933,0,29,0,29,0,0
장암마을,90155,91,73,91,73,0,5
장암마을,90156,17,20,17,20,0,1
장애인복지관,37249,2313,2677,2302,2677,11,160
장애인종합복지관,43320,0,1,0,1,0,0
장애인종합복지관,43627,7,12,7,12,0,0
장인가구,39706,290,217,290,217,0,16
장자말,43142,22,53,22,53,0,2
장자말,43257,93,0,93,0,0,3
장자촌,43141,21,0,19,0,2,0
장자촌,43255,0,3,0,3,0,0
장전,43415,29,13,29,13,0,1
장전,43500,1,9,1,9,0,0
장정2리마을회관,43665,1,96,1,96,0,3
장정2리마을회관,43693,161,0,153,0,8,5
장지포,90238,1,11,1,11,0,0
장지포,90239,30,3,30,3,0,1
장천사거리,37282,1795,2527,1795,2527,0,139
장천사거리,37610,296,1133,296,1133,0,46
장천사거리,37651,410,1299,410,1299,0,55
장촌길 입구,90379,11,5,11,5,0,0
장촌길 입구,90382,2,3,2,3,0,0
장촌마을,35475,232,11,231,11,1,7
장촌마을,35476,11,193,11,193,0,6
장촌빌라,35321,212,10,211,10,1,7
장촌빌라,35397,8,120,8,120,0,4
장하,43184,3,39,3,39,0,1
장하,43204,53,1,50,1,3,1
장화교회앞,43121,36,43,34,43,2,2
장화교회앞,43539,60,27,56,27,4,2
장화리학생수련원,43426,70,60,70,60,0,4
장화리학생수련원,43474,9,26,9,26,0,1
장흥낚시터,43211,1,3,1,3,0,0
장흥낚시터,43890,0,1,0,1,0,0
장흥리종점,43643,19,18,19,18,0,1
장흥리종점,43888,6,16,6,16,0,0
장흥매점,43641,0,1,0,1,0,0
장흥매점,43891,2,5,2,5,0,0
장흥삼거리,43153,37,4,36,4,1,1
장흥삼거리,43881,11,44,11,44,0,1
장흥저수지(성공회.해든뮤지움),90081,211,148,211,148,0,11
장흥저수지(성공회.해든뮤지움),90082,58,143,58,143,0,6
재능대·한국외대 송도캠퍼스,38754,43,2,43,2,0,1
재능대·한국외대 송도캠퍼스,38755,6,759,6,759,0,24
재활용품수집장,43165,3,3,3,3,0,0
저수지관리소,43264,18,0,18,0,0,0
저수지휴게소,43567,18,38,18,38,0,1
적두마을(월곳교회),43190,51,0,50,0,1,1
적두마을(월곳교회),43709,0,65,0,65,0,2
적석사입구,43348,31,47,29,47,2,2
적석사입구,43847,66,4,59,4,7,2
전동교회,35199,6515,4245,6484,4245,31,347
전동교회,35200,2208,7070,2197,7070,11,299
전득이고개입구,90187,13,13,12,13,1,0
전득이고개입구,90188,7,30,6,30,1,1
전들,43477,37,11,37,11,0,1
전들,43835,2,39,2,39,0,1
전등사남문,43515,128,259,122,259,6,12
전등사남문,43893,213,93,213,93,0,9
전등사동문,43521,162,733,160,733,2,28
전등사동문,43895,513,301,512,301,1,26
전소,35231,6393,4668,6388,4668,5,356
전소,35232,5845,6088,5843,6088,2,384
전원미술관앞,43387,249,11,247,11,2,8
전원미술관앞,43810,1,281,0,281,1,9
전인연립(종점),40132,112,315,112,315,0,13
절아래,90401,11,33,11,33,0,1
절아래,90402,38,9,38,9,0,1
점촌,43414,44,0,39,0,5,1
점촌,43806,1,33,1,33,0,1
젓개마을,35828,2,123,1,123,1,4
젓개마을,35829,1,2,1,2,0,0
젓개마을입구,35322,3,5,2,5,1,0
정광아파트(병무청),37008,4399,29,4384,29,15,142
정광아파트(병무청),37009,6,4611,6,4611,0,148
정광아파트.만수주공11단지,39476,6786,7099,6770,7099,16,447
정광아파트.만수주공11단지,39477,7322,4431,7303,4431,19,379
정기무역,35083,1392,154,1361,154,31,49
정다운그린빌,92024,1919,3238,1919,3238,0,166
정든마을아파트,40055,2182,4238,2171,4238,11,207
정든마을아파트,40057,5104,1862,5086,1862,18,224
정병원,40413,5187,4557,5184,4557,3,314
정부인천지방합동청사,37386,33562,14798,33539,14798,23,1560
정부인천지방합동청사,37388,24443,29162,24414,29162,29,1729
정비단지,37005,2147,1615,2147,1615,0,121
정비단지,37006,906,2342,906,2342,0,104
정서진삼거리,89234,1,535,1,535,0,17
정석항공과학고,37168,21729,5291,21721,5291,8,871
정석항공과학고,37170,9251,19383,9248,19383,3,923
정수사입구,43404,56,17,53,17,3,2
정수사입구,43436,10,14,10,14,0,0
정하,43183,31,5,31,5,0,1
정하,43208,7,22,7,22,0,0
제물포시장,37310,777,641,777,641,0,45
제물포시장,37311,839,939,839,939,0,57
제물포여자중학교,37288,3602,1887,3597,1887,5,177
제물포여자중학교,37290,5624,5168,5605,5168,19,348
제물포여자중학교,37298,7132,10432,7097,10432,35,566
제물포역,37355,55535,34080,55477,34080,58,2890
제물포역,37364,26025,18874,25996,18874,29,1448
제물포역,37496,31488,40639,31381,40639,107,2326
제물포역,37498,17547,5624,17547,5624,0,747
제물포역,37502,25626,34616,25607,34616,19,1943
제물포역(동양빌딩),37339,939,5034,939,5034,0,192
제물포중학교,42064,1802,2416,1791,2416,11,136
제물포중학교,42065,2462,1469,2449,1469,13,126
제운사거리(청년창업특화거리),37175,3301,5102,3284,5102,17,271
제운사거리(청년창업특화거리),37534,4517,5729,4501,5729,16,330
제일시장,37316,7020,6444,7020,6444,0,434
제일시장,37329,10235,10942,10214,10942,21,683
제일시장사거리,37667,1122,632,1122,632,0,56
제일주유소,57020,2536,1344,2536,1344,0,125
제일주유소,57021,1006,3828,1006,3828,0,155
제일풍경채,42833,3158,3815,3151,3815,7,224
제일풍경채1차정문앞,89350,1661,1432,1661,1432,0,99
제일풍경채2차,89349,18,311,18,311,0,10
제일풍경채2차321동앞,42866,3072,995,3067,995,5,131
제일풍경채2차321동앞,42873,234,1167,224,1167,10,45
제일풍경채2차323동앞,42891,6454,5605,6450,5605,4,389
제일풍경채2차331동앞,42989,2080,3346,2078,3346,2,175
제적봉앞마을,90060,0,2,0,2,0,0
제적봉입구,43654,0,14,0,14,0,0
제적봉입구,43686,1,3,1,3,0,0
조광교회입구,43533,3,0,3,0,0,0
조광교회입구,43868,0,44,0,44,0,1
조달청(한양2차아파트),37511,6222,13266,6206,13266,16,628
조달청비축기지,35114,1333,5508,1321,5508,12,220
조달청비축기지,35115,4135,1743,4125,1743,10,189
조동초등학교,39464,3006,1702,3006,1702,0,151
조동초등학교,39465,28,1198,28,1198,0,39
조리미입구,80068,1455,48,1455,48,0,48
조리미입구,80069,52,1312,52,1312,0,44
조바위,90350,0,23,0,23,0,0
조바위,90351,9,1,9,1,0,0
조산,43192,8,53,8,53,0,1
조산,43334,84,12,81,12,3,3
조산교회,43172,3,21,3,21,0,0
조산교회,43338,57,1,54,1,3,1
조산초등학교,43189,25,163,24,163,1,6
조산초등학교,43593,191,16,189,16,2,6
종갱이,43180,60,178,60,178,0,7
종갱이,43288,99,51,98,51,1,4
종근당,40002,192,20,192,20,0,6
종근당,40005,15,683,15,683,0,22
종근당.충정로역,11002,383,7897,383,7897,0,267
종로약국,57005,728,1086,728,1086,0,58
종로약국,57007,1993,897,1993,897,0,93
종생마을,80161,947,144,942,144,5,35
종생마을,80162,83,1275,80,1275,3,43
종점(병무청),37014,2160,23,2160,23,0,70
종합터미널,37242,43771,20685,43620,20685,151,2079
종합터미널,39177,13245,37521,13224,37521,21,1637
종현동정보화마을,62043,28,124,26,124,2,4
종현동정보화마을,62044,217,28,216,28,1,7
좌동교차로,89371,0,101,0,101,0,3
좌동마을,42452,188,53,188,53,0,7
좌동마을,89253,84,221,84,221,0,9
좌동마을입구,42456,45,91,45,91,0,4
좌동마을입구,42928,207,38,206,38,1,7
주거단지,35118,427,450,424,450,3,28
주거단지,35120,238,715,236,715,2,30
주공12단지,35082,945,166,945,166,0,35
주공12단지,35084,396,462,396,462,0,27
주공6단지후문,40453,4536,2648,4536,2648,0,231
주공뜨란채아파트,40708,3528,3114,3508,3114,20,214
주공뜨란채아파트,40803,4009,3028,3995,3028,14,227
주공아파트,40867,423,848,420,848,3,41
주물단지,42291,1303,3786,1301,3786,2,164
주안1동행정복지센터,37385,5237,7112,5236,7112,1,398
주안2동치안센터,37302,6667,4930,6664,4930,3,374
주안4동행정복지센터,37333,106,240,105,240,1,11
주안4동행정복지센터,37335,46,459,46,459,0,16
주안5동행정복지센터,37526,606,1051,606,1051,0,53
주안7동행정복지센터,37214,19172,20193,19097,20193,75,1269
주안7동행정복지센터,37216,22533,16710,22451,16710,82,1265
주안국가산단역,37583,7595,727,7595,727,0,268
주안국가산단역,37584,45,2284,45,2284,0,75
주안남초등학교,37283,7438,8337,7401,8337,37,508
주안남초등학교,37284,11921,4540,11896,4540,25,531
주안도서관,37341,478,368,478,368,0,27
주안도서관,37342,465,427,465,427,0,28
주안매매단지,37586,309,251,309,251,0,18
주안북부,37471,2228,9048,2228,9048,0,363
주안북부역,37418,17427,12161,17418,12161,9,954
주안북부역,37420,17275,12290,17273,12290,2,953
주안북초등학교,37417,4198,6752,4197,6752,1,353
주안사거리,37330,17425,11959,17312,11959,113,947
주안사거리,37514,3027,8579,3027,8579,0,374
주안시범공단,39927,171,455,171,455,0,20
주안아파트,37207,816,2257,775,2257,41,99
주안아파트,37209,1280,1204,1257,1204,23,80
주안역,37387,84089,32396,83927,32396,162,3757
주안역,37389,19988,72765,19952,72765,36,2992
주안역,37402,900,3853,900,3853,0,153
주안역,37506,24543,17822,24459,17822,84,1366
주안역센트레빌아파트,37430,7588,9689,7586,9689,2,557
주안역센트레빌아파트정문,37490,683,943,683,943,0,52
주안역환승정류장,37503,86295,64726,86273,64726,22,4871
주안역환승정류장,37617,111254,86428,111254,86428,0,6376
주안파크자이더플래티넘아파트,37201,19177,9994,19108,9994,69,941
주안파크자이더플래티넘아파트,37204,9305,19276,9224,19276,81,921
주안현대아파트,37358,17170,16200,17116,16200,54,1076
주원고개,39377,1105,3491,1086,3491,19,148
주원고개,39396,3260,8699,3248,8699,12,385
주적골,39510,410,1723,408,1723,2,68
주적골,39608,411,821,411,821,0,39
주택마을,90230,3,117,2,117,1,3
중고등학교,44106,11,12,4,12,7,0
중고등학교,44193,8,12,8,12,0,0
중고차매매단지엠파크허브,42038,440,666,440,666,0,35
중구노인복지회관,35151,11818,10142,11776,10142,42,708
중구노인복지회관,35152,12077,10708,12049,10708,28,735
중구문화회관,35466,2,727,2,727,0,23
중구문화회관,35467,1746,365,1739,365,7,68
중구청,35157,2260,1391,2257,1391,3,117
중구청,35159,688,2979,687,2979,1,118
중구청소년수련관.하늘중학교,35824,244,401,244,401,0,20
중독고개,43936,23,32,23,32,0,1
중박골입구,44123,10,16,10,16,0,0
중박골입구,44194,32,0,25,0,7,1
중봉로교차로,89420,1696,2531,1695,2531,1,136
중봉로교차로,89421,1494,821,1492,821,2,74
중부고용노동청(인천고용센터),39222,599,644,598,644,1,40
중부고용노동청(인천고용센터),39223,545,463,542,463,3,32
중산고등학교,35868,110,239,110,239,0,11
중산고등학교,35869,358,474,358,474,0,26
중산교차로,35652,730,502,729,502,1,39
중산교차로,35653,455,2922,455,2922,0,108
중산동,35305,1815,532,1815,532,0,75
중산동(까치빌라앞),35247,441,729,441,729,0,37
중산동(중촌),35272,589,1233,589,1233,0,58
중산동(중촌),35278,12,252,12,252,0,8
중산중고등학교,35817,117,97,117,97,0,6
중산중고등학교,35818,13,7,13,7,0,0
중산중학교,35656,488,338,486,338,2,26
중산중학교,35657,311,611,311,611,0,29
중앙공영아파트,41268,4237,1324,4237,1324,0,179
중앙공원사거리,39189,461,818,459,818,2,41
중앙방앗간,35852,6,27,6,27,0,1
중앙방앗간,35853,5,6,5,6,0,0
중앙사료,42014,1936,1436,1934,1436,2,108
중앙사료,42015,690,1115,689,1115,1,58
중앙산부인과,70176,14,262,14,262,0,8
중앙산부인과,70230,438,67,438,67,0,16
중앙시장,90125,1856,776,1785,776,71,84
중앙시장.고려궁지입구,43067,1131,1830,1119,1830,12,95
중앙아파트,40409,656,697,653,697,3,43
중앙아파트,42315,3246,1916,3246,1916,0,166
중앙하이츠,41110,3554,11658,3548,11658,6,490
중앙호수공원입구(호반베르디움),89245,16,558,16,558,0,18
중원고등학교,55078,2187,773,2187,773,0,95
중촌,43252,173,3,168,3,5,5
중촌,43369,0,61,0,61,0,1
중촌교차로,35436,150,578,150,578,0,23
중촌교차로,35443,981,317,980,317,1,41
중혈마을,43176,5,33,5,33,0,1
중혈마을,43299,73,1,72,1,1,2
중흥S클래스,42832,2890,1562,2884,1562,6,143
중흥S클래스,42847,605,405,605,405,0,32
중흥S클래스1차,42844,452,792,452,792,0,40
중흥S클래스1차,42845,742,614,742,614,0,43
중흥S클래스2차,42771,4488,1526,4469,1526,19,194
중흥S클래스2차,42856,4394,1114,4394,1114,0,177
중흥마을.은하마을,55070,448,292,448,292,0,23
지랏돌,90071,45,8,44,8,1,1
지랏돌,90072,0,23,0,23,0,0
지산리입구,43310,3,0,3,0,0,0
지산리입구,43751,2,19,2,19,0,0
지산입구(용진),43538,21,0,21,0,0,0
지산입구(용진),43679,2,15,2,15,0,0
지석리마을회관,90274,10,5,10,5,0,0
지석리망향단입구,90273,2,4,2,4,0,0
지석리오현부락,90275,44,27,44,27,0,2
지석초등학교입구,90277,57,10,57,10,0,2
지식정보단지역,38373,9391,1298,9391,1298,0,344
지식정보단지역,38403,4338,1248,4338,1248,0,180
지식정보단지역,38404,487,3962,487,3962,0,143
지식정보단지역(4번출구),38380,545,9265,545,9265,0,316
진고개(5연대입구),43380,245,156,242,156,3,12
진고개(5연대입구),43794,39,204,38,204,1,7
진광횟집앞,43507,26,3,25,3,1,0
진광횟집앞,43541,1,12,1,12,0,0
진달래아파트,37600,12,763,12,763,0,25
진두방앗간,44129,0,43,0,43,0,1
진두방앗간,44195,24,2,22,2,2,0
진산과학고등학교,40640,2,232,2,232,0,7
진산과학고등학교,40915,116,1,116,1,0,3
진산중학교,40575,943,2254,940,2254,3,103
진산초등학교,40614,944,3508,944,3508,0,143
진산초등학교,40633,7,168,2,168,5,5
진산초등학교,40914,224,11,207,11,17,7
진솔인더스트리,89447,326,2,326,2,0,10
진솔인더스트리,89448,1,342,1,342,0,11
진웅종점,42803,10,1237,6,1237,4,40
진웅종점,42804,2038,22,2010,22,28,66
진주5단지503동앞,42089,3300,2819,3294,2819,6,197
진주상가,42544,3495,276,3470,276,25,121
진주아파트2단지,42092,370,11178,365,11178,5,372
진주아파트2단지6동,42084,103,6552,103,6552,0,214
진주아파트3단지,42086,8707,242,8659,242,48,288
진주아파트4단지,42077,3513,145,3504,145,9,118
진표에너지,42548,3,329,3,329,0,10
진흥아파트,37190,2727,2139,2712,2139,15,156
진흥아파트,37193,2310,3318,2279,3318,31,181
진흥아파트,37240,5704,4270,5697,4270,7,321
진흥아파트,37243,5990,10398,5980,10398,10,528
진흥아파트,39297,7054,6902,7054,6902,0,450
집단에너지,39064,232,176,232,176,0,13
집단에너지시설,39065,90,211,90,211,0,9
짓절미,43485,27,10,26,10,1,1
짓절미,43713,18,14,18,14,0,1
찬우물,39179,1119,3061,1119,3061,0,134
찬우물,39188,1617,791,1614,791,3,77
찬우물,43048,108,321,104,321,4,13
찬우물약수터,43851,160,231,158,231,2,12
참빛감리교회,42437,16330,10323,16303,10323,27,859
참좋은집,36160,341,3,339,3,2,11
참좋은집,36161,17,415,15,415,2,13
창골,43549,252,99,248,99,4,11
창리,43052,314,270,313,270,1,18
창리,43053,293,353,285,353,8,20
창리,43054,389,304,383,304,6,22
창리,43902,24,38,22,38,2,2
창리,43903,4,1,4,1,0,0
창신초등학교,42620,3274,2770,3271,2770,3,194
창신초등학교,42621,4339,4633,4338,4633,1,289
창후1리마을회관,43595,163,3,162,3,1,5
창후1리마을회관,43783,2,215,2,215,0,7
창후리입구,43604,208,18,179,18,29,7
창후리입구,43830,17,193,15,193,2,6
창후리종점,43774,16,63,12,63,4,2
창후정미소,43461,97,5,95,5,2,3
창후정미소,43600,20,60,20,60,0,2
채석장,38179,1028,387,1028,387,0,45
채플 갤러리,90422,1,0,1,0,0,0
채플 갤러리,90423,0,10,0,10,0,0
천곡,43409,144,3,137,3,7,4
천곡,43827,25,144,25,144,0,5
천촌,43411,4,112,4,112,0,3
천촌,43795,133,1,131,1,2,4
철곶,43653,5,20,5,20,0,0
철곶,43759,18,1,17,1,1,0
철산리검문소,43957,6,16,6,16,0,0
철산리검문소,43958,43,10,42,10,1,1
철산리입구,43685,27,21,26,21,1,1
철산리입구,43741,8,36,8,36,0,1
첨단초등학교,92014,428,3907,428,3907,0,139
청광플러스원101동앞,92070,260,3391,260,3391,0,117
청광플러스원102동앞,39946,845,95,845,95,0,30
청광플러스원아파트,39775,5481,2874,5475,2874,6,269
청광플러스원아파트,39786,2357,7160,2355,7160,2,307
청능로사거리,39622,39866,16914,39801,16914,65,1831
청능로사거리,39623,19053,40198,18995,40198,58,1911
청라1동행정복지센터,42744,13686,5682,13686,5682,0,624
청라1동행정복지센터,42745,7675,10201,7675,10201,0,576
청라1호문화공원,89470,4,0,4,0,0,0
청라1호문화공원,89471,4,0,4,0,0,0
청라2동행정복지센터,89039,2903,809,2903,809,0,119
청라2동행정복지센터,89042,1674,3108,1674,3108,0,154
청라3동행정복지센터,89374,1513,5895,1513,5895,0,238
청라3동행정복지센터,89375,6963,1299,6963,1299,0,266
청라BRT차고지입구,89336,24,699,9,699,15,23
청라BRT차고지입구,89337,641,48,621,48,20,22
청라고등학교,42784,1937,526,1937,526,0,79
청라고등학교,42785,532,2120,532,2120,0,85
청라골프아카데미,89255,127,64,127,64,0,6
청라골프아카데미,89256,60,138,60,138,0,6
청라국제도서관,42922,35,254,35,254,0,9
청라국제도서관,42923,431,104,431,104,0,17
청라국제도시역,89270,56930,660,56930,660,0,1857
청라국제도시역(1번출구),89043,26053,36230,26042,36230,11,2009
청라국제도시역(경명대로),89034,7939,8711,7910,8711,29,537
청라국제도시역(영종방향),89215,32501,26084,32495,26084,6,1889
청라국제도시역푸르지오시티,89523,22,70,22,70,0,2
청라국제도시역푸르지오시티,89524,45,75,45,75,0,3
청라국제어린이집,89289,337,57,337,57,0,12
청라국제업무단지(골드클래스),42984,812,546,810,546,2,43
청라꽃농원,42991,84,86,83,86,1,5
청라달튼국제학교,42895,1186,461,1186,461,0,53
청라달튼국제학교,89121,885,924,885,924,0,58
청라도,42931,13,89,12,89,1,3
청라도,89127,3,48,3,48,0,1
청라디이스트,42961,103,1208,100,1208,3,42
청라디이스트(562동),42962,1583,3735,1582,3735,1,171
청라디이스트(567동),89017,939,164,938,164,1,35
청라로데오시티포레안,89419,110,257,110,257,0,11
청라로봇랜드,89246,25,10,25,10,0,1
청라로봇랜드,89247,1,110,1,110,0,3
청라모아미래도,89353,19,70,19,70,0,2
청라문학공원,89480,61,31,61,31,0,2
청라백세요양병원,42944,144,113,143,113,1,8
청라백세요양병원,89179,145,163,143,163,2,9
청라복합문화센터,89218,192,1464,192,1464,0,53
청라복합문화센터,89219,1020,272,1020,272,0,41
청라센텀로제비앙,89295,1382,1296,1382,1296,0,86
청라센텀로제비앙,89296,1437,1321,1437,1321,0,88
청라센텀로제비앙정문앞,89346,62,19,62,19,0,2
청라센트럴에일린의뜰,42834,4578,4441,4564,4441,14,290
청라센트럴에일린의뜰104동,42990,3799,1696,3797,1696,2,177
청라센트럴에일린의뜰106동,42892,9555,5545,9542,5545,13,487
청라스타필드,89417,278,309,276,309,2,18
청라스타필드,89418,361,569,361,569,0,30
청라시티프라디움,89334,1732,2005,1730,2005,2,120
청라시티프라디움,89335,2941,1016,2941,1016,0,127
청라우미린,42862,667,3722,667,3722,0,141
청라우미린아파트,89290,3134,9996,3134,9996,0,423
청라웰카운티221동,89288,69,496,69,496,0,18
청라웰카운티223동,42997,1154,275,1154,275,0,46
청라자이,42742,10124,2649,10117,2649,7,412
청라중앙호수공원입구,89021,12780,9779,12780,9779,0,727
청라중앙호수공원입구,89024,8278,13426,8278,13426,0,700
청라중학교,42848,913,1917,913,1917,0,91
청라초등학교,89281,5761,7048,5761,7048,0,413
청라초등학교,89282,4615,6580,4615,6580,0,361
청라파크자이상가,89299,734,996,733,996,1,55
청라파크자이상가,89300,690,555,689,555,1,40
청라푸르지오,89217,831,1310,831,1310,0,69
청라푸르지오라피아노,89497,7,45,7,45,0,1
청라푸르지오라피아노,89498,8,30,8,30,0,1
청라한양수자인레이크블루,89348,2496,2007,2496,2007,0,145
청라한양수자인레이크블루,89351,2322,1327,2322,1327,0,117
청라한화꿈에그린,89123,1446,590,1446,590,0,65
청라한화꿈에그린,89124,547,881,547,881,0,46
청라호반베르디움.포리공원,42899,1764,394,1764,394,0,69
청라호반베르디움.포리공원,42919,738,1723,738,1723,0,79
청라호수공원(남측),42861,2304,759,2304,759,0,98
청라호수공원(남측),42863,903,2127,903,2127,0,97
청라호수공원한신더휴,42870,6071,1093,6051,1093,20,231
청라호수공원한신더휴아파트,89291,13661,6231,13661,6231,0,641
청라힐스테이트,42987,1005,2895,1005,2895,0,125
청라힐스테이트,42988,2890,579,2885,579,5,111
청람중학교,89018,1320,1665,1320,1665,0,96
청람중학교,89019,2169,1718,2167,1718,2,125
청람초등학교,89279,6706,10554,6706,10554,0,556
청람초등학교,89280,10148,8098,10148,8098,0,588
청량중학교,38086,9746,4144,9731,4144,15,448
청련사입구,43766,69,100,68,100,1,5
청련사입구,43841,101,3,100,3,1,3
청룡정,41633,58,16,58,16,0,2
청룡정,41634,3,107,2,107,1,3
청소년수련관,42612,2958,56,2952,56,6,97
청소년수련관,42613,35,3178,26,3178,9,103
청소년수련관,43078,63,14,62,14,1,2
청소년수련관,43079,8,23,8,23,0,1
청소년수련관.어린이과학관,41307,10162,8587,10125,8587,37,604
청소년수련관.어린이과학관,41308,5707,7725,5679,7725,28,433
청송1단지.중흥S클래스,80090,183,173,183,173,0,11
청송1단지.중흥S클래스,80102,554,290,552,290,2,27
청송2.3단지,80089,77,101,77,101,0,5
청송2.3단지,80101,332,77,330,77,2,13
청송마을.성우오스타,80329,150,109,150,109,0,8
청송부락,90092,1,5,1,5,0,0
청양골,42775,5,63,5,63,0,2
청운대삼거리(하늘꿈교회),37433,5230,4437,5198,4437,32,311
청운대삼거리(하늘꿈교회),37500,2752,3057,2743,3057,9,187
청운대후문.한전제물포지사,37632,366,960,366,960,0,42
청운대후문.한전제물포지사,37633,131,1124,131,1124,0,40
청정주말농장,39852,0,70,0,70,0,2
청천농장,40538,139,1583,139,1583,0,55
청천농장,42511,1417,304,1413,304,4,55
청천농장(종점),40520,3249,12,3186,12,63,105
청천농장입구,40558,394,202,380,202,14,19
청천농장입구,40809,1,447,1,447,0,14
청천도서관,40426,1093,1779,1093,1779,0,92
청천도서관,40427,817,866,817,866,0,54
청천동,40808,888,11,888,11,0,29
청천동무지개아파트,40617,751,3573,748,3573,3,139
청천동무지개아파트,40618,2944,715,2932,715,12,118
청천동차고지,40925,314,351,283,351,31,21
청천중학교,40449,1555,2752,1544,2752,11,138
청천중학교,40455,624,2854,620,2854,4,112
청천천공영주차장,40896,324,1738,324,1738,0,66
청천천공영주차장,41639,488,1491,488,1491,0,63
청천초등학교,40582,3305,5404,3288,5404,17,280
청천초등학교,40586,18332,7045,18242,7045,90,818
청천초등학교,40587,3927,12190,3899,12190,28,519
청천초등학교후문,40574,1409,13175,1401,13175,8,470
청천초등학교후문,40579,13281,1387,13241,1387,40,473
청천치안센터,40533,31543,14633,31400,14633,143,1489
청천치안센터,40537,9625,14196,9600,14196,25,768
청천푸르지오아파트,40488,9580,87,9513,87,67,311
청천푸르지오아파트,40515,12116,1461,12113,1461,3,437
청천푸르지오아파트,40516,1520,8793,1516,8793,4,332
청천푸르지오아파트,40811,7338,1525,7337,1525,1,285
청천푸르지오아파트,40812,808,4497,808,4497,0,171
청천푸르지오아파트,40894,24,2241,24,2241,0,73
청천하우스디아파트,40475,5931,1968,5923,1968,8,254
청천하우스디아파트,40477,665,4361,664,4361,1,162
청학동.한국전력남인천지사,38230,2701,3838,2690,3838,11,210
청학동.한국전력남인천지사,38239,7709,5913,7698,5913,11,439
청학사거리,38256,22396,14973,22389,14973,7,1205
청학사거리,38259,10065,14382,10059,14382,6,788
청학사거리,38509,1718,1725,1718,1725,0,111
청학아파트,38236,9482,5808,9472,5808,10,493
청학아파트,38341,6404,7039,6403,7039,1,433
청학중학교,38160,3433,4964,3433,4964,0,270
청학중학교,38161,3395,2018,3395,2018,0,174
청학중학교,38496,749,366,749,366,0,35
청학초등학교,38181,2737,3033,2737,3033,0,186
청학초등학교,38185,2710,2463,2710,2463,0,166
청학초등학교,38190,1579,2803,1571,2803,8,141
체육공원,90214,18,7,18,7,0,0
체육공원앞,35605,7,292,7,292,0,9
체육공원앞,35606,195,3,195,3,0,6
초은고등학교,89025,9430,7182,9430,7182,0,535
초은고등학교,89026,3233,10075,3233,10075,0,429
초정마을,41252,3003,2412,3003,2412,0,174
초정마을,41254,1801,569,1801,569,0,76
초지,43016,8,59,8,59,0,2
초지대교,43017,172,393,169,393,3,18
초지대교,43071,1491,431,1484,431,7,62
초지대교,43106,279,727,279,727,0,32
초지리,43026,107,164,103,164,4,8
초지리,43093,2,57,2,57,0,1
초지삼거리,43112,62,50,61,50,1,3
초지삼거리,43147,0,8,0,8,0,0
초지삼거리,43508,4,82,4,82,0,2
초지진,43024,10,54,10,54,0,2
초지진,43025,120,98,120,98,0,7
초지큰말,43260,41,0,38,0,3,1
초지큰말,43512,0,17,0,17,0,0
축현초등학교.인천시립박물관,38151,4656,3179,4648,3179,8,252
축현초등학교.인천시립박물관,38152,2553,4228,2547,4228,6,218
축협,43061,1113,1021,1089,1021,24,68
충렬사,43326,8,0,8,0,0,0
충렬사,43629,45,60,45,60,0,3
충성아파트,40117,997,1590,996,1590,1,83
충정로역2호선,22064,8478,63,8478,63,0,275
치마바위,43247,1,17,1,17,0,0
치마바위,43646,6,0,6,0,0,0
카페거리,35727,19,16,19,16,0,1
카페거리,35728,9,63,9,63,0,2
칼빈매니토바국제학교,38370,1851,3690,1851,3690,0,178
칼빈매니토바국제학교,38435,914,393,914,393,0,42
칼빈매니토바국제학교,38500,4600,1832,4587,1832,13,207
캐슬해모로,39845,1102,223,1102,223,0,42
캐슬해모로,39846,5278,524,5278,524,0,187
캐슬해모로,39848,352,809,352,809,0,37
캐슬해모로,39849,873,4034,873,4034,0,158
캠퍼스타운역,38419,9016,18620,9015,18620,1,891
캠퍼스타운역,38420,8396,6260,8396,6260,0,472
캠퍼스타운역(3번출구),38388,44,2717,43,2717,1,89
캠퍼스타운역(3번출구),38717,590,19,590,19,0,19
커넬워크,38415,893,395,893,395,0,41
커넬워크,38417,2442,1620,2438,1620,4,131
커넬워크,38753,99,2151,99,2151,0,72
커넬워크(4동),38527,642,1081,642,1081,0,55
컨벤시아,38372,1110,2376,1109,2376,1,112
코세스물류창고,89197,101,1,101,1,0,3
코스모스아파트,42098,303,983,299,983,4,41
코오롱더프라우,38439,30,1013,30,1013,0,33
코오롱아파트작전중.고.여고,41117,2314,3521,2290,3521,24,188
"쿠팡16,17센터",35865,413,642,413,642,0,34
쿠팡물류센터,89157,2,713,2,713,0,23
큐티엘,90218,10,0,10,0,0,0
큰말,43937,25,0,24,0,1,0
큰말,43938,0,29,0,29,0,0
큰말,43949,11,13,11,13,0,0
큰말,90309,5,5,4,5,1,0
큰무리선착장,35710,88,64,88,64,0,4
큰무리선착장,35712,13,227,13,227,0,7
큰방죽사거리,39144,2182,3042,2179,3042,3,168
큰방죽사거리,39145,1392,2546,1389,2546,3,127
큰방죽삼거리,39575,38,207,38,207,0,7
큰방죽삼거리,39576,49,336,49,336,0,12
큰산너머입구,44013,7,109,7,109,0,3
큰산너머입구,44014,134,8,130,8,4,4
킹스빌타운,41315,2698,2853,2684,2853,14,179
타운하우스공장.명진화학,89226,9,168,9,168,0,5
타운하우스공장.명진화학,89227,211,9,211,9,0,7
탄토 마을,90381,13,1,13,1,0,0
탄토마을,90378,2,16,2,16,0,0
탑재,43115,2,27,2,27,0,0
탑재,43327,259,242,256,242,3,16
탑재,43579,200,267,200,267,0,15
태경아파트,38275,8168,8651,8167,8651,1,542
태산.대진아파트,38294,2841,2681,2838,2681,3,178
태산아파트,41193,7309,10116,7302,10116,7,562
태산아파트,42227,549,418,548,418,1,31
태신보세창고,89236,72,220,72,220,0,9
태신보세창고,89237,794,30,792,30,2,26
태양공단,42147,2143,1683,2140,1683,3,123
태양공단,42148,2035,2120,2030,2120,5,134
태양주택,40204,19,962,19,962,0,31
태영아파트,42298,2922,2770,2920,2770,2,183
태영아파트,42300,2869,2720,2868,2720,1,180
태평1차아파트,39241,3637,383,3637,383,0,129
태평1차아파트,39242,250,3722,250,3722,0,128
태평1차아파트,39516,9103,1984,9090,1984,13,357
태평1차아파트,39517,2081,10166,2077,10166,4,395
태평2차아파트,39225,11044,3726,11033,3726,11,476
태평2차아파트,39518,3544,7908,3535,7908,9,369
태평아파트,38083,8224,6858,8205,6858,19,486
태평아파트,41183,1258,153,1241,153,17,45
태평아파트.주안한신휴플러스아파트,37180,2410,4444,2349,4444,61,221
태평아파트.주안한신휴플러스아파트,37183,1473,1900,1457,1900,16,108
태평아파트1차(A),42326,4623,11333,4622,11333,1,514
태평아파트1차(B),42325,11622,4256,11622,4256,0,512
태평아파트2차(A),42317,2480,3077,2480,3077,0,179
태평아파트2차(B),42318,5260,3043,5259,3043,1,267
태평아파트입구,39274,78,1391,78,1391,0,47
태평아파트입구,39276,317,190,316,190,1,16
태평양산업,39066,2757,696,2755,696,2,111
태평양인천물류센터,42012,1817,1965,1816,1965,1,122
태화.두진아파트,39441,8090,5509,8072,5509,18,438
태화두진아파트,39445,6480,7036,6478,7036,2,436
태화아파트,37413,4330,3211,4330,3211,0,243
태화아파트,37416,4516,4756,4516,4756,0,299
태화아파트,40545,8140,3536,8138,3536,2,376
태화아파트,40810,1723,26,1723,26,0,56
태화한진아파트,41132,4184,2595,4181,2595,3,218
태화한진아파트612동,41135,1164,3012,1164,3012,0,134
택리,43233,54,8,49,8,5,2
택리,43859,11,50,11,50,0,1
택리교회,43229,16,81,16,81,0,3
택리교회,43860,152,12,145,12,7,5
테니스장,40456,204,171,204,171,0,12
테일코리아,89430,312,142,312,142,0,14
테일코리아,89431,599,429,599,429,0,33
테크노파크IT센타,39726,829,3096,829,3096,0,126
테크노파크IT센타,39727,3094,2303,3094,2303,0,174
테크노파크IT센터,39938,2243,3742,2243,3742,0,193
테크노파크역,38421,29539,18370,29530,18370,9,1545
테크노파크역,38422,28892,24712,28892,24712,0,1729
토지금고,37114,8316,2443,8282,2443,34,347
토지금고,37115,3673,11329,3642,11329,31,483
토지금고시장,37102,17723,13357,17716,13357,7,1002
토지금고시장앞,37509,9215,10060,9207,10060,8,621
통진성당,80137,1271,345,1268,345,3,52
통진성당,80138,284,1200,282,1200,2,47
통진중고등학교,35073,2484,429,2454,429,30,93
통진중고등학교,35074,366,2455,363,2455,3,91
트러스(서구장애인직업재활시설),42809,352,2,352,2,0,11
트러스(서구장애인직업재활시설),42810,0,185,0,185,0,5
트레지움1단지.다니엘병원,55076,2184,879,2184,879,0,98
트레지움1단지.다니엘병원,55077,768,1657,768,1657,0,78
파라곤보타닉파크,89422,2748,41,2748,41,0,89
파라곤보타닉파크(고산터널),89395,9859,2417,9859,2417,0,396
파라다이스공원,43391,112,7,109,7,3,3
파라다이스공원,43828,4,106,4,106,0,3
파라다이스시티역,35748,0,26,0,26,0,0
팔도주유소,40175,175,298,175,298,0,15
팔도주유소,40774,8933,6687,8897,6687,36,503
팬더아파트,39968,417,5,415,5,2,13
팬더아파트,39980,5,325,5,325,0,10
펜션마을,90392,1,14,1,14,0,0
펜션마을,90393,8,0,7,0,1,0
평전,43258,0,65,0,65,0,2
평화전망대,43743,23,67,23,67,0,2
평화전망대,43760,49,2,49,2,0,1
포내교회,35874,23,4,23,4,0,0
포내교회,35875,13,33,13,33,0,1
포도마을,55039,2782,2825,2767,2825,15,180
포도마을사거리.현대백화점.이마트,55055,9878,8663,9870,8663,8,598
포도밭,43939,19,13,19,13,0,1
포도밭,43940,12,21,12,21,0,1
포레시안101동앞,39729,5946,4845,5945,4845,1,348
포레시안101동앞,39730,4541,3674,4541,3674,0,265
포스코타워앤쉐라톤호텔,38491,2993,1466,2989,1466,4,143
푸르지오더베뉴(3216동),89442,343,1875,343,1875,0,71
푸르지오더베뉴후문,89423,33,2704,33,2704,0,88
푸르지오더스카이,35844,4458,1797,4450,1797,8,201
푸르지오더스카이,35845,2087,2533,2080,2533,7,149
푸르지오더스카이256동,35508,405,25,404,25,1,13
푸르지오더스카이256동,35509,52,347,52,347,0,12
푸르지오월드마크,38471,9268,13293,9250,13293,18,727
푸르지오하버뷰,38456,203,604,203,604,0,26
푸르지오하버뷰,38522,1125,2466,1125,2466,0,115
푸른초장,90052,2,106,2,106,0,3
푸른초장,90053,71,2,68,2,3,2
풍류산,90129,1,18,1,18,0,0
풍류산,90130,21,0,21,0,0,0
풍림1단지정문,70007,5,892,5,892,0,28
풍림1차205동,35255,2891,5379,2891,5379,0,266
풍림1차205동,35256,8918,4285,8917,4285,1,425
풍림1차아파트,42970,4295,11772,4292,11772,3,518
풍림1차아파트,,12638,3984,12637,3984,1,536
풍림2.3차아파트,38350,10095,2448,10095,2448,0,404
풍림2단지,70010,2,1204,2,1204,0,38
풍림2차,42485,9931,47,9931,47,0,321
풍림2차아파트,38049,5711,13664,5697,13664,14,625
풍림2차아파트,38050,6979,5626,6949,5626,30,406
풍림3단지정문,70003,199,155,194,155,5,11
풍림3차아파트,42366,8553,4764,8553,4764,0,429
풍림6단지,35124,2230,693,2227,693,3,94
풍림아이원,36114,126,1175,125,1175,1,41
풍림아이원,36115,6371,1809,6367,1809,4,263
풍림아이원,36121,2610,8859,2607,8859,3,369
풍림아이원,41441,3629,1957,3622,1957,7,180
풍림아이원아파트,37034,17029,8199,17008,8199,21,813
풍림아파트,36122,6237,562,6200,562,37,219
풍림아파트,37245,22790,6477,22759,6477,31,944
풍림아파트,37246,5797,12252,5781,12252,16,582
풍림아파트,38255,3510,6092,3510,6092,0,309
풍림아파트,39162,7345,11236,7333,11236,12,599
풍림아파트,39163,12485,5527,12445,5527,40,581
풍림아파트,41374,2664,2346,2660,2346,4,161
풍림아파트,70008,606,5,598,5,8,19
풍림아파트(소래마을),39120,1028,3243,1022,3243,6,137
풍림아파트104동,40898,6951,6220,6942,6220,9,424
풍림아파트104동,40899,4824,5014,4824,5014,0,317
풍림아파트상가,70043,227,397,227,397,0,20
풍림아파트상가,70044,470,121,454,121,16,19
풍림엑슬루타워,42830,7791,7303,7779,7303,12,486
풍무역,80167,430,4387,430,4387,0,155
풍무역,80168,3253,369,3253,369,0,116
풍물시장,35054,276,1167,268,1167,8,46
풍물시장,35055,244,7,243,7,1,8
풍물시장,43941,137,7659,131,7659,6,251
풍산빌라 입구,90384,4,6,4,6,0,0
풍산특수금속,90219,17,5,15,5,2,0
프라임,39643,4950,1420,4950,1420,0,205
프리상뜨아파트,40230,105,3684,105,3684,0,122
프린피아통합물류센터,89235,331,3,329,3,2,10
하나개삼거리,35733,4,34,4,34,0,1
하나개삼거리,35734,11,24,11,24,0,1
하나개해수욕장,35737,171,666,171,666,0,27
하나글로벌캠퍼스,89444,1398,497,1396,497,2,61
하나글로벌캠퍼스,89445,499,4410,499,4410,0,158
하나금융그룹통합데이터센터,89265,269,2033,269,2033,0,74
하나금융그룹통합데이터센터,89294,337,199,337,199,0,17
하나로쇼핑,37118,3291,8257,3253,8257,38,372
하나모터스,89451,449,1,446,1,3,14
하나모터스,89452,1,314,1,314,0,10
하나아파트,37052,9192,2873,9187,2873,5,389
하나아파트,40546,1077,1588,1077,1588,0,85
하나아파트,41250,4811,5735,4803,5735,8,340
하나아파트,41574,2629,551,2624,551,5,102
하나아파트101동,41578,1164,1982,1164,1982,0,101
하늘도시중심상가,35821,2177,323,2165,323,12,80
하늘도시중심상가,35822,442,2041,439,2041,3,80
하늘문화센터,35826,2,69,2,69,0,2
하늘문화센터,35827,46,0,46,0,0,1
하늘문화센터입구,35766,1,82,0,82,1,2
하늘문화센터입구,35767,15,6,15,6,0,0
하늘중학교,35823,228,254,226,254,2,15
하늘초등학교후문,35499,241,241,241,241,0,15
하늘초등학교후문,35500,115,823,115,823,0,30
하늘휴게소,70220,2248,5444,2248,5444,0,248
하늘휴게소,70221,5401,2318,5401,2318,0,249
하룩,43157,36,185,36,185,0,7
하룩,43281,224,42,220,42,4,8
하리마을회관,90243,1,8,1,8,0,0
하리마을회관,90244,7,0,7,0,0,0
하리선착장,90240,5,21,5,21,0,0
하야동,41438,317,495,317,495,0,26
하야동,41439,484,557,481,557,3,33
하얀마을,55035,2259,2478,2259,2478,0,152
하얀집민박,43440,20,6,20,6,0,0
하얀집민박,43497,5,15,5,15,0,0
하얏트호텔,35028,1309,10300,1308,10300,1,374
하얏트호텔,35206,3588,3153,3588,3153,0,217
하우고개,43275,54,96,53,96,1,4
하우고개,43577,138,59,135,59,3,6
하우스앞,43174,26,0,26,0,0,0
하우스앞,43231,3,24,3,24,0,0
하우스토리,41569,218,185,214,185,4,13
하우스토리,41570,112,1239,99,1239,13,43
하우스토리,41606,345,517,345,517,0,27
하우스토리,41626,681,322,680,322,1,32
하우스토리만수아파트,39301,817,782,814,782,3,51
하일부락입구,43967,18,2,18,2,0,0
하일부락입구,43971,2,16,2,16,0,0
하점공단,43448,7,51,7,51,0,1
하점공단,43755,39,6,33,6,6,1
하점면사무소,43738,336,221,321,221,15,17
하점면사무소,43834,180,295,169,295,11,15
하점순복음교회,90222,173,2,171,2,2,5
하점순복음교회,90223,4,51,4,51,0,1
하점우체국,43817,537,116,503,116,34,21
하점우체국,43838,87,594,87,594,0,21
하점초등학교,43739,1,110,1,110,0,3
하점초등학교,43836,102,7,97,7,5,3
하정초등학교,40044,1518,1038,1510,1038,8,82
하정초등학교,,673,2016,671,2016,2,86
학마을한진아파트정문,41293,1753,2907,1752,2907,1,150
학산사거리,37025,5877,263,5866,263,11,198
학산사거리,37027,175,2977,173,2977,2,101
학산사거리,37562,1819,1223,1819,1223,0,98
학산소극장,37169,18966,4023,18959,4023,7,741
학산소극장,37173,7817,16298,7814,16298,3,777
학생안전체험관,39284,1957,4450,1948,4450,9,206
학익.원흥아파트,37015,1617,42,1601,42,16,53
학익2동행정복지센터,37150,13536,7528,13509,7528,27,679
학익2동행정복지센터,37151,7847,13067,7814,13067,33,674
학익고등학교,37029,8920,2669,8914,2669,6,373
학익고등학교,37505,2375,10088,2373,10088,2,402
학익동구치소,37139,294,995,294,995,0,41
학익동성당앞,37630,1294,26,1294,26,0,42
학익동성당앞,37631,66,684,66,684,0,24
학익사거리,37058,13,572,13,572,0,18
학익사거리,37075,2874,1513,2867,1513,7,141
학익사거리,37077,2098,5868,2093,5868,5,256
학익사거리(동아풍림아파트),37084,10209,4696,10193,4696,16,480
학익사거리(동아풍림아파트),37089,8809,8588,8763,8588,46,561
학익시장,37106,13048,5056,13031,5056,17,584
학익시장,37112,2676,11041,2664,11041,12,442
학익시장(법원검찰청),37080,8864,4109,8829,4109,35,418
학익시장앞,37082,3929,5137,3922,5137,7,292
학익여자고등학교,37140,286,1033,286,1033,0,42
학익여자고등학교,37566,478,825,478,825,0,42
학익풍림아파트,37487,22,2611,22,2611,0,84
한가라지고개,90157,0,1,0,1,0,0
한가라지고개,90158,0,4,0,4,0,0
한가라지입구,90159,12,3,12,3,0,0
한가라지입구,90160,4,3,4,3,0,0
한가람마을우미린.호수이편한세상,80318,1107,3110,1106,3110,1,136
한강센트럴블루힐.모아엘가2차,80375,301,347,301,347,0,20
한국가스공사,39061,807,1005,805,1005,2,58
한국가스공사,89273,201,672,201,672,0,28
한국가스공사,89274,131,492,131,492,0,20
한국가스공사인천지역본부,89114,16,67,16,67,0,2
한국가스공사인천지역본부,89115,59,35,59,35,0,3
한국건설생활환경시험연구원,39312,281,285,268,285,13,18
한국건설생활환경시험연구원,39315,609,2339,600,2339,9,95
한국공항공사,25002,65,1180,65,1180,0,40
한국공항공사,25144,24,21,24,21,0,1
한국국토정보공사인천북부지사,42278,5321,6358,5307,6358,14,376
한국국토정보공사인천북부지사,42280,5802,3476,5792,3476,10,299
한국글로벌셰프고등학교,43246,122,84,122,84,0,6
한국글로벌셰프고등학교,43381,44,60,42,60,2,3
한국단자공업연구소,38763,154,366,154,366,0,16
한국단자공업연구소,38764,43,139,43,139,0,5
한국도심공항터미널,35400,8,66,2,66,6,2
한국도심공항터미널,35408,27,178,27,178,0,6
한국도심공항터미널,35417,88,17,88,17,0,3
한국도심공항터미널앞,35645,40,7,38,7,2,1
한국마쓰이,39055,1008,1260,1008,1260,0,73
한국마쓰이,39057,2748,1658,2748,1658,0,142
한국만화박물관,40583,4968,14096,4954,14096,14,614
한국무역센터.삼성역,23201,1353,13,1353,13,0,44
한국무역센터.삼성역,23251,2980,2880,2980,2880,0,189
한국산업단지공단,39060,687,114,687,114,0,25
한국산업단지공단,39067,38,855,38,855,0,28
한국생산기술연구원,38448,157,436,157,436,0,19
한국생산기술연구원(주조기술센터),42271,405,711,405,711,0,36
한국생산기술연구원(주조기술센터),42719,290,293,290,293,0,18
한국샤프(로얄금속),40600,2578,3553,2575,3553,3,197
한국선교역사기념관,40673,1968,779,1968,779,0,88
한국아파트,37017,2919,8457,2909,8457,10,366
한국아파트,38154,2911,1701,2905,1701,6,148
한국아파트,40714,98,1661,98,1661,0,56
한국아파트,40715,2137,84,2137,84,0,71
한국아파트,40790,14482,14300,14465,14300,17,928
한국아파트,40791,14368,11867,14324,11867,44,846
한국아파트,40792,4011,14067,3985,14067,26,583
한국아파트,40816,10376,9263,10367,9263,9,633
한국아파트,41206,6329,3564,6280,3564,49,319
한국아파트,41208,2162,3935,2104,3935,58,196
한국아파트,80057,2020,46,2020,46,0,66
한국외대송도캠퍼스,38768,0,34,0,34,0,1
한국전력,42947,69,257,69,257,0,10
한국지엠청라주행시험장,89412,1684,1108,1667,1108,17,90
한국지엠청라주행시험장,89413,927,392,924,392,3,42
한국지엠출고문,40560,3681,6166,3675,6166,6,317
한국지엠출고문,40570,4686,3434,4686,3434,0,261
한국콘베어공업,92049,1,0,1,0,0,0
한국타이어인천물류센터,89221,582,990,580,990,2,50
한국타이어인천물류센터,89222,579,779,576,779,3,43
한국특수주물(주),42575,450,284,450,284,0,23
한국폴리텍2대학남인천캠퍼스,37448,828,729,828,729,0,50
한국폴리텍2대학남인천캠퍼스,37450,379,458,379,458,0,27
한남시티플라자,40253,20725,12606,20719,12606,6,1075
한들마을입구(유아교육진흥원),42370,8478,5668,8472,5668,6,456
한들마을입구(유아교육진흥원),42371,2768,4139,2760,4139,8,222
한라비발디,35459,8503,2943,8493,2943,10,369
한라비발디,35460,8533,13392,8531,13392,2,707
한라비발디,89180,2235,1070,2235,1070,0,106
한라비발디,89181,1560,3156,1560,3156,0,152
한라비발디정문,89373,54,1165,54,1165,0,39
한라비발디후문.화성파크드림,35658,519,899,517,899,2,45
한라시멘트,35291,135,435,132,435,3,18
한라아파트,39117,1276,3433,1270,3433,6,151
한라아파트,39118,5140,1369,5100,1369,40,209
한림병원,41130,14576,10737,14576,10737,0,816
한림병원,41131,12124,18195,12124,18195,0,978
한미반도체,42754,537,1302,537,1302,0,59
한미반도체,42755,328,235,328,235,0,18
한빛초교앞,39773,1524,6989,1524,6989,0,274
한빛초교앞,39774,5799,2841,5792,2841,7,278
한사랑어린이집,42461,5,93,5,93,0,3
한성아파트,89020,809,1572,809,1572,0,76
한성자동차학원,42091,830,1684,827,1684,3,81
한수조경,43681,1,14,1,14,0,0
한수조경,43882,0,3,0,3,0,0
한스엔지니어링,42276,323,249,323,249,0,18
한스엔지니어링,42279,536,467,536,467,0,32
한신더휴스카이파크,35654,1186,1160,1185,1160,1,75
한신더휴스카이파크,35655,1742,893,1742,893,0,85
한신더휴어반파크,89521,21,141,21,141,0,5
한신더휴테라스,35761,134,50,133,50,1,5
한신더휴테라스,35762,53,86,53,86,0,4
한신빌리지(A),42249,514,2371,514,2371,0,93
한신빌리지(B),42246,3686,636,3671,636,15,139
한신빌리지(C),42229,2213,676,2191,676,22,93
한신빌리지아파트,42230,515,1148,514,1148,1,53
한신삼부아파트,40806,1850,2564,1850,2564,0,142
한신아파트,37262,5022,3515,5019,3515,3,275
한신아파트,37264,8560,9113,8548,9113,12,570
한신아파트,37267,12863,9664,12845,9664,18,726
한신아파트,41066,2167,1518,2166,1518,1,118
한신아파트,41067,2070,1693,2065,1693,5,121
한신아파트,42095,17,870,17,870,0,28
한신휴아파트,40245,4685,54,4685,54,0,152
한신휴아파트,42105,39688,18809,39564,18809,124,1887
한신휴아파트,42106,2911,1848,2909,1848,2,153
한양2차아파트,37512,10968,4360,10968,4360,0,494
한양2차아파트,38055,5751,4947,5738,4947,13,345
한양공구,39664,72,1,72,1,0,2
한양공구,39753,0,52,0,52,0,1
한양공구,42071,384,7797,384,7797,0,263
한양쇼핑,40331,1340,7047,1333,7047,7,270
한양쇼핑,40333,4030,2271,4023,2271,7,203
한양수자인,35450,3242,380,3242,380,0,116
한양수자인,42868,4839,2419,4833,2419,6,234
한양수자인,42893,3129,3546,3124,3546,5,215
한양수자인(후문),35537,4155,826,4152,826,3,160
한양아파트,37076,2006,6440,2000,6440,6,272
한양아파트,37079,5302,626,5298,626,4,191
한양아파트,40269,412,279,412,279,0,22
한양아파트,40310,14198,4193,14166,4193,32,593
한양아파트,40356,14145,8825,14122,8825,23,740
한양아파트,40905,36,324,36,324,0,11
한양아파트2차,38062,3553,5703,3548,5703,5,298
한양화학,42523,3948,1550,3948,1550,0,177
한일금속,89487,7,1302,7,1302,0,42
한일금속,89488,1262,8,1260,8,2,40
한일베라체,42839,4081,1117,4072,1117,9,167
한일베라체,42865,1029,2443,1026,2443,3,112
한일베라체,42948,3718,1649,3717,1649,1,173
한일아파트,41295,973,2123,964,2123,9,99
한일아파트,41296,1952,1071,1901,1071,51,97
한일아파트,80195,83,1233,83,1233,0,42
한일튜브(주),42576,481,210,481,210,0,22
한전사택,44090,10,50,10,50,0,1
한전사택,44197,1,0,1,0,0,0
한전온수출장소,43012,172,404,172,404,0,18
한주글로벌,89306,39,431,36,431,3,15
한진,38540,3,275,3,275,0,8
한진,38541,346,7,346,7,0,11
한진아파트,38016,24595,16900,24565,16900,30,1338
한진아파트,41355,182,440,182,440,0,20
한진아파트후문,41300,2348,419,2342,419,6,89
한풍산업,39014,537,970,537,970,0,48
한화2차,40363,2746,1252,2732,1252,14,128
한화꿈에그린,42860,1016,197,1015,197,1,39
한화꿈에그린,42872,330,1026,328,1026,2,43
한화꿈에그린정문,89372,2600,2196,2600,2196,0,154
한화아파트,40351,11664,6930,11655,6930,9,599
한화아파트,40379,2652,2315,2625,2315,27,160
한화아파트,40380,4335,2193,4305,2193,30,210
한화아파트,41375,3409,2735,3394,2735,15,198
한화지구공원앞,39654,1621,894,1621,894,0,81
한희빌딩,39311,1429,5077,1417,5077,12,209
함박도서관,38286,4930,2980,4930,2980,0,255
함박도서관,38742,523,1949,523,1949,0,79
함박마을,38277,6049,2533,6049,2533,0,276
함박마을문화복지센터,38291,4677,1607,4677,1607,0,202
함박마을문화복지센터,38741,179,2182,179,2182,0,76
함박마을입구,38285,2617,8208,2617,8208,0,349
함허동천,43352,26,40,26,40,0,2
함허동천,43403,65,11,62,11,3,2
합동청사역,35207,22817,6159,22800,6159,17,934
합정역,14220,191,8353,191,8353,0,275
합정역,23029,233,25503,233,25503,0,830
합정역,23030,31285,547,31285,547,0,1026
항동7가버스차고지,35609,1346,33,1161,33,185,44
항동7가버스차고지,35610,182,1049,51,1049,131,39
항동7가버스차고지(삼거리),35704,100,340,17,340,83,14
항동7가버스차고지(삼거리),35705,647,11,595,11,52,21
항운아파트,35065,15705,3524,15639,3524,66,620
항운아파트,35481,960,8583,953,8583,7,307
항운아파트,35602,418,2561,418,2561,0,96
항진축산,39056,784,1849,784,1849,0,84
항진축산,39058,1654,1247,1654,1247,0,93
항청리종점,43558,124,115,119,115,5,7
항포,90247,2,1,2,1,0,0
항포,90248,6,3,6,3,0,0
해광병원,40292,85,2533,85,2533,0,84
해넘이마을,90135,7,13,7,13,0,0
해넘이마을,90136,24,32,24,32,0,1
해돋이공원,38008,45,249,45,249,0,9
해돋이공원,38010,411,841,411,841,0,40
해돋이공원,38718,61,80,61,80,0,4
해돋이도서관,38729,217,33,215,33,2,8
해돋이도서관,38730,7,625,7,625,0,20
해뜨는집앞,35531,4,42,4,42,0,1
해뜨는집앞,35726,59,7,58,7,1,2
해망,90352,0,3,0,3,0,0
해망,90353,15,1,15,1,0,0
해맞이공원앞,35616,333,736,333,736,0,34
해맞이공원앞,35617,639,325,638,325,1,31
해명초등학교앞,90179,11,22,11,22,0,1
해명초등학교앞,90180,22,47,21,47,1,2
해모로월드뷰,39794,1325,374,1325,374,0,54
해모로월드뷰,39805,378,1048,378,1048,0,46
해물탕거리,40782,3475,2090,3475,2090,0,179
해병2사단.향동,80054,810,711,809,711,1,49
해사고등학교,35503,569,14,569,14,0,18
해사고등학교.한국이민사박물관,35126,17,1185,17,1185,0,38
해서초등학교,41166,541,639,539,639,2,38
해서초등학교,41168,508,1167,507,1167,1,54
해성단조,42813,46,1,46,1,0,1
해송노인요양병원,35552,1,78,1,78,0,2
해송노인요양병원,35553,15,3,14,3,1,0
해수워터피아,42082,3223,819,3223,819,0,130
해수워터피아,42083,1328,7487,1328,7487,0,284
해안도로신항만교,39001,300,905,300,905,0,38
해안도로신항만교,39002,696,764,696,764,0,47
해암약수,90161,13,6,13,6,0,0
해암약수,90162,4,5,4,5,0,0
해양경찰청,38014,1949,3305,1939,3305,10,169
해양경찰청,38015,5830,3666,5821,3666,9,306
해양경찰청,38411,10251,7622,10251,7622,0,576
해양기계,39532,10,71,10,71,0,2
해양기계,39696,4,185,4,185,0,6
해오름민박,43413,67,18,67,18,0,2
해오름민박,43442,18,50,17,50,1,2
해원고등학교,42964,23,577,23,577,0,19
해원중학교,42972,1018,109,1012,109,6,36
해원중학교,42973,75,775,75,775,0,27
해원중학교후문,42965,949,410,943,410,6,43
해피타운앞,44139,30,8,29,8,1,1
해피타운앞,44198,19,50,17,50,2,2
핸즈코퍼레이션,89262,12,2391,12,2391,0,77
핸즈코퍼레이션,89263,3,48,3,48,0,1
햇내로공원입구,35777,22,0,22,0,0,0
햇내로공원입구,35784,2,21,2,21,0,0
행복마을입구,35687,80,18,76,18,4,3
행복마을입구,35690,15,75,15,75,0,2
행자골,43350,0,9,0,9,0,0
행자골,43583,19,7,19,7,0,0
행정복지센터사거리,40332,1036,2722,1032,2722,4,121
향나무골,43131,20,7,18,7,2,0
향나무골,43648,39,25,39,25,0,2
향동해병2사단,80055,961,1464,958,1464,3,78
향촌휴먼시아2단지,39741,8220,14730,8220,14730,0,740
허브주유소,35446,279,406,279,406,0,22
허브주유소,35447,368,6478,368,6478,0,220
허튼개,90119,0,6,0,6,0,0
허튼개,90120,17,3,17,3,0,0
헤나무,43199,0,59,0,59,0,1
헤나무,43317,44,10,43,10,1,1
혁이네슈퍼,40738,20,600,20,600,0,20
혁이네슈퍼,40739,317,31,317,31,0,11
현광아파트,37007,2209,9,2202,9,7,71
현광아파트,37488,6,2269,4,2269,2,73
현광아파트,39380,16412,16939,16380,16939,32,1075
현광아파트,41071,5954,1662,5954,1662,0,245
현광아파트,41432,3060,6383,3060,6383,0,304
현광아파트,42258,89,339,89,339,0,13
현광아파트,42260,573,188,570,188,3,24
현광아파트(호산부인과),39376,29557,16137,29492,16137,65,1474
현광아파트후문,37560,2593,15,2589,15,4,84
현광아파트후문앞,37559,27,1434,1,1434,26,47
현대.태화아파트,41402,574,3851,573,3851,1,142
현대102동,40146,2373,766,2373,766,0,101
현대121동,40137,5457,759,5457,759,0,200
현대1단지관리사무소,40740,224,2235,224,2235,0,79
현대1차아파트,38061,6596,3709,6590,3709,6,332
현대1차아파트,41365,9436,697,9428,697,8,326
현대1차아파트정문,41367,199,329,195,329,4,17
현대207동,40168,543,8770,543,8770,0,300
현대209동,40167,9124,503,9124,503,0,310
현대2차아파트,38173,2071,2769,2063,2769,8,156
현대2차아파트,41106,711,4126,711,4126,0,156
현대2차아파트,41112,8385,665,8378,665,7,291
현대2차아파트,41366,526,5943,526,5943,0,208
현대2차아파트정문,41364,450,5792,446,5792,4,201
현대310동(서중학교),40097,126,1643,126,1643,0,57
현대3단지,40127,8946,6327,8927,6327,19,492
현대3단지,40129,8336,10609,8305,10609,31,611
현대3차아파트,38168,16493,10508,16419,10508,74,871
현대3차아파트,38342,15163,13804,15124,13804,39,934
현대4차아파트,38158,1857,2500,1856,2500,1,140
현대4차아파트,38183,2324,2997,2308,2997,16,171
현대4차아파트,38186,3632,1484,3621,1484,11,165
현대5차,40405,9704,7107,9667,7107,37,542
현대5차,40408,6241,3528,6189,3528,52,315
현대5차아파트,38176,3387,1502,3376,1502,11,157
현대동부시장,36041,11337,5790,11266,5790,71,552
현대모닝.임광그대가아파트,39579,7031,3104,7027,3104,4,326
현대백화점,22003,3516,46,3516,46,0,114
현대슈퍼,43376,361,22,361,22,0,12
현대슈퍼,43617,5,149,5,149,0,4
현대시장,36042,8804,5706,8753,5706,51,468
현대시장,36043,6999,8965,6966,8965,33,514
현대시장,36118,6502,8720,6473,8720,29,491
현대써비스,42021,3880,3156,3879,3156,1,226
현대아파트,35396,308,19,308,19,0,10
현대아파트,37154,2975,6946,2974,6946,1,320
현대아파트,37161,6263,3520,6263,3520,0,315
현대아파트,39267,5584,4704,5561,4704,23,331
현대아파트,39271,5218,3185,5190,3185,28,271
현대아파트,40112,33480,26829,33411,26829,69,1945
현대아파트,40681,1762,7568,1758,7568,4,300
현대아파트,40682,8090,1459,8086,1459,4,308
현대아파트,40737,628,1887,626,1887,2,81
현대아파트,40788,35750,32996,35718,32996,32,2217
현대아파트,43082,65,389,65,389,0,14
현대아파트,43083,387,97,384,97,3,15
현대아파트.통진도서관,80135,169,766,164,766,5,30
현대아파트.통진도서관,80136,984,160,981,160,3,36
현대아파트105동,40734,80,846,78,846,2,29
현대아파트105동,40735,589,210,589,210,0,25
현대아파트113동,40105,8006,5813,7977,5813,29,445
현대아파트116동,40732,1658,382,1658,382,0,65
현대아파트119동,40733,60,2502,60,2502,0,82
현대아파트120동앞,40140,334,4808,334,4808,0,165
현대오일뱅크,41459,2450,1608,2445,1608,5,130
현대자동차빌딩앞,40103,4841,11486,4819,11486,22,526
현대자동차서비스,42032,10110,3088,10095,3088,15,425
현대자동차서비스,42033,13979,9501,13942,9501,37,757
현대제철,36086,469,1291,469,1291,0,56
현대제철,36123,2784,769,2777,769,7,114
현대제철정문,36133,569,1336,563,1336,6,61
현대철강레이져,90220,0,44,0,44,0,1
현대철강레이져,90221,13,0,13,0,0,0
현송중학교,38744,4762,1188,4762,1188,0,191
현송중학교,38745,1263,3357,1263,3357,0,149
형제마트,40004,479,1756,452,1756,27,72
형제마트,40006,1506,587,1488,587,18,67
혜덕,90217,3,3,3,3,0,0
혜성프라자,40393,22412,13274,22354,13274,58,1151
혜성프라자,40395,16276,17496,16247,17496,29,1089
호구포역,39784,5749,7726,5747,7726,2,434
호구포역,39785,10156,7886,10153,7886,3,582
호구포역2번출구,92040,1575,478,1575,478,0,66
호명사입구,40093,28,647,11,647,17,21
호박골,43437,46,24,42,24,4,2
호박골,43784,84,28,79,28,5,3
호박골사거리,43123,0,38,0,38,0,1
호박골사거리,43124,94,10,94,10,0,3
호박골사거리,43706,8,270,8,270,0,8
호박골사거리,43804,125,20,125,20,0,4
호반베르디움,42855,522,4993,522,4993,0,177
호반베르디움14단지,42880,1157,3650,1148,3650,9,155
호반베르디움214동앞,42998,171,692,171,692,0,27
호반베르디움2차,89112,1405,1233,1405,1233,0,85
호반베르디움2차,89113,1347,1202,1347,1202,0,82
호반베르디움3차아파트,42743,2360,6498,2358,6498,2,285
호반베르디움3차아파트,42908,1007,4196,1004,4196,3,167
호반베르디움아파트,39922,2767,781,2767,781,0,114
호반베르디움아파트107동,92011,4114,229,4113,229,1,140
호반써밋1차 3101동,89393,669,2567,669,2567,0,104
호반써밋1차 3101동,89394,1468,204,1468,204,0,53
호반써밋1차아파트,89472,876,455,876,455,0,42
호반써밋1차아파트,89473,1706,2211,1706,2211,0,126
호반써밋송도,38637,5099,128,5094,128,5,168
호반써밋송도(109동),38634,928,1992,928,1992,0,94
호반써밋스카이센트럴1차아파트,35892,209,757,208,757,1,31
호반써밋스카이센트럴1차아파트,35893,506,253,504,253,2,24
호불사입구,38180,2379,2758,2375,2758,4,165
호불사입구,38182,2670,2203,2669,2203,1,157
호세요양원,43221,16,117,16,117,0,4
호세요양원,43311,8,9,8,9,0,0
호수공원,89103,75,487,75,487,0,18
호수공원,89104,2596,565,2596,565,0,101
호수공원음악분수,89027,1807,1131,1797,1131,10,94
호수공원음악분수,89028,971,2076,971,2076,0,98
호수마을5단지후문,35270,54,42,54,42,0,3
호수마을5단지후문,35735,56,60,56,60,0,3
호수마을이편한세상.한가람우미린,80319,1012,555,1005,555,7,50
홈씨씨인천점,42955,62,346,60,346,2,13
홈씨씨인천점,42957,101,42,101,42,0,4
홈씨씨인천점,89188,432,699,432,699,0,36
홈플러스,80070,242,2587,242,2587,0,91
홈플러스,89225,692,392,692,392,0,34
홈플러스,35218,457,1508,457,1508,0,63
홈플러스.산림조합,80018,3029,158,3029,158,0,102
홈플러스계산점,41622,34,1738,34,1738,0,57
홍대입구역,23011,212,5587,212,5587,0,187
홍대입구역,23031,39917,513,39917,513,0,1304
홍대입구역,23032,362,18800,362,18800,0,618
홍예문·공영주차장,35794,19,213,19,213,0,7
홍예문·공영주차장,35806,24,267,24,267,0,9
홍의사거리,43798,64,67,63,67,1,4
홍의사거리,43813,15,25,15,25,0,1
홍의삼거리,43441,7,16,7,16,0,0
홍의삼거리,43613,52,44,52,44,0,3
홍익자원,35514,1372,560,1370,560,2,62
홍익자원,35515,51,1090,47,1090,4,36
홍현마을,90002,25,7,24,7,1,1
홍현마을,90003,3,37,3,37,0,1
화개사입구,90034,1,80,1,80,0,2
화개사입구,90035,87,3,85,3,2,2
화개정원,90405,3,69,3,69,0,2
화곡역,16147,46134,51080,46134,51080,0,3135
화도,43077,132,120,131,120,1,8
화도고개,36027,1676,2391,1668,2391,8,131
화도고개,36028,1507,4110,1488,4110,19,181
화도돈대,43676,24,5,24,5,0,0
화도돈대,43863,4,34,4,34,0,1
화도진공원.화도진도서관,36033,11005,2979,10960,2979,45,451
화도진공원.화도진도서관,36035,3418,10948,3406,10948,12,463
화도진중학교,36064,2926,590,2891,590,35,113
화도진중학교,36066,772,3045,755,3045,17,123
화도터미널,43104,950,1273,925,1273,25,71
화도터미널,43105,1470,743,1460,743,10,71
화력발전소,42628,231,243,231,243,0,15
화문석문화관,43452,0,3,0,3,0,0
화문석문화관,43697,1,0,1,0,0,0
화물터미널,35039,19,420,19,420,0,14
화물터미널,35040,289,25,289,25,0,10
화성보일러,39107,2912,6055,2912,6055,0,289
화성파크드림.스카이시티자이,35651,6917,1827,6915,1827,2,282
화성파크드림후문.한라비발디,35659,623,997,623,997,0,52
화수부두,36147,633,1516,613,1516,20,69
화수사거리,36072,2435,782,2414,782,21,103
화수사거리,36104,294,1487,286,1487,8,57
화전초교사거리,41087,913,1169,913,1169,0,67
화전초등학교,41085,1037,451,1037,451,0,48
화전초등학교,41086,570,569,570,569,0,36
화평철교.화평동냉면거리,36014,3418,3171,3406,3171,12,212
화평철교.화평동냉면거리,36016,15415,21668,15366,21668,49,1196
화훼단지,89489,5,5,5,5,0,0
화훼단지·당미교,41462,73,281,73,281,0,11
화훼단지·당미교,41463,77,163,77,163,0,7
환경공단강화사업소,90109,0,2,0,2,0,0
환경공단강화사업소,90110,2,0,2,0,0,0
황곡노인정,89310,32,1,25,1,7,1
황곡노인정,89320,118,104,109,104,9,7
황곡상회,89311,30,0,29,0,1,0
황곡상회,89330,1,37,1,37,0,1
황골,43992,3,42,3,42,0,1
황골,43993,70,5,60,5,10,2
황골마을,43135,8,10,8,10,0,0
황골마을,43277,17,2,17,2,0,0
황련사입구,43328,76,74,76,74,0,4
황련사입구,43630,35,0,35,0,0,1
황산도,43635,23,41,18,41,5,2
황산도관광밸트,43873,3,8,3,8,0,0
황산도관광밸트,43876,3,6,3,6,0,0
황산도입구,43636,36,16,36,16,0,1
황산도입구,43861,11,19,11,19,0,0
황청리종점,90207,4,0,4,0,0,0
효성2동치안센터,41024,2034,8745,2028,8745,6,347
효성고등학교,41074,1262,296,1252,296,10,50
효성고등학교,41075,409,2074,405,2074,4,80
효성남초등학교,41040,5829,2677,5829,2677,0,274
효성노인문화센터,41409,597,1615,595,1615,2,71
효성노인문화센터,41410,589,798,589,798,0,44
효성농협,41039,2599,1478,2561,1478,38,131
효성뉴서울아파트,41060,11296,1566,11267,1566,29,414
효성뉴서울아파트,41061,2195,12606,2159,12606,36,477
효성뉴서울아파트202동,41078,1571,15438,1571,15438,0,548
효성뉴서울아파트204동,41368,12920,1535,12904,1535,16,466
효성대신아파트,41041,5135,2791,5065,2791,70,255
효성대신아파트,41042,412,3735,405,3735,7,133
효성도서관,41420,2514,392,2510,392,4,93
효성동동화운수차고지,41573,7808,3447,7741,3447,67,363
효성명현초등학교,41065,2730,681,2687,681,43,110
효성사거리,41017,901,5144,897,5144,4,195
효성사거리,41018,10641,4238,10592,4238,49,479
효성사거리,41019,5048,5631,5032,5631,16,344
효성사거리,41631,790,889,786,889,4,54
효성상아아파트,39357,13710,15952,13661,15952,49,956
효성상아아파트,39358,18253,13311,18180,13311,73,1018
효성서초등학교,41557,3027,494,3027,494,0,113
효성서초등학교,41558,500,2786,500,2786,0,106
효성서초등학교,41579,159,880,159,880,0,33
효성서초등학교,41580,1548,639,1548,639,0,70
효성성모병원,41022,4455,230,4455,230,0,151
효성소방파출소,41023,7972,2838,7933,2838,39,348
효성신사거리,41030,1530,8109,1526,8109,4,310
효성신사거리,41031,7134,1336,7101,1336,33,273
효성아파트,42166,8895,2371,8895,2371,0,363
효성아파트,42168,2445,7923,2445,7923,0,334
효성중앙교회,41021,155,7195,154,7195,1,237
효성프라자,41052,10040,9129,9942,9129,98,618
효성프라자,41055,5721,5110,5675,5110,46,349
효성현대3차,41049,1319,3161,1297,3161,22,144
효성현대3차아파트,41051,870,435,848,435,22,42
효성현대4차,41035,1767,4084,1727,4084,40,188
효성현대4차아파트,41036,4065,1317,4010,1317,55,173
효자교앞,90199,2,1,2,1,0,0
효자교앞,90200,4,14,4,14,0,0
효정아파트,38260,1364,1614,1364,1614,0,96
후정초등학교.삼산도서관,40685,92,1360,92,1360,0,46
후지테크,39051,2353,1389,2350,1389,3,120
후지테크,39052,613,2271,611,2271,2,93
후포항입구,43431,28,140,28,140,0,5
후포항입구,43481,112,41,98,41,14,4
휴먼시아1단지,40837,2934,6658,2929,6658,5,309
휴먼시아1단지,40838,6057,1661,6051,1661,6,248
휴먼시아1단지,40840,880,2,880,2,0,28
휴먼시아1단지,40852,126,1875,126,1875,0,64
휴먼시아후문,42885,8909,3936,8903,3936,6,414
흥성리,18804,3,194,3,194,0,6
흥성리,62029,248,12,247,12,1,8
흥왕2리마을회관 앞,43122,29,65,28,65,1,3
흥왕2리마을회관 앞,43520,38,35,38,35,0,2
흥왕리,90073,0,7,0,7,0,0
흥왕리,90074,5,10,4,10,1,0
흥왕상회,43502,30,15,30,15,0,1
흥왕상회,43516,13,10,12,10,1,0
희경산업·남동스카이장례식장,39031,281,168,281,168,0,14
희경산업·남동스카이장례식장,39961,55,247,55,247,0,9
희망찬요양병원,38126,4855,6997,4847,6997,8,382
희망천입구,40091,5329,4561,5299,4561,30,319
희망천입구,40799,5481,5120,5463,5120,18,341
희망체육공원입구,40912,5417,41,5400,41,17,176
희성금속,42018,110,519,110,519,0,20
힐데스하임,42876,8724,2227,8724,2227,0,353
힐스테이트,35457,15925,9315,15907,9315,18,814
힐스테이트,35458,6543,4731,6542,4731,1,363
힐스테이트레이크송도(후문),38630,2199,1498,2199,1498,0,119
힐스테이트레이크송도(후문),38656,1758,1315,1758,1315,0,99
힐스테이트레이크송도1차입구,38655,1039,811,1039,811,0,59
힐스테이트레이크송도1차입구,38751,409,926,409,926,0,43
힐스테이트레이크송도2차(201동),38641,2014,1974,2014,1974,0,128
힐스테이트레이크송도2차(201동),38657,1496,1183,1496,1183,0,86
힐스테이트송도더테라스(정문),38715,1561,332,1561,332,0,61
힐스테이트송도더테라스(정문),38716,235,929,235,929,0,37
힐스테이트송도더테라스(후문),38713,3031,2324,3031,2324,0,172
힐스테이트송도더테라스(후문),38714,764,2171,764,2171,0,94
힐스테이트푸르지오주안,37293,34621,37390,34543,37390,78,2322
힐스테이트푸르지오주안아파트,37680,9461,11063,9440,11063,21,662
힐스테이트학익,37022,5064,4564,5047,4564,17,310
힐스테이트학익,37023,4575,6827,4560,6827,15,367
힐스테이트학익104동앞,37669,1327,1790,1327,1790,0,100
힐스테이트학익104동앞,37670,2287,4579,2287,4579,0,221
힐캐슬프라자,39329,11126,16393,11097,16393,29,887
힐캐슬프라자,39331,18433,9424,18390,9424,43,898
힘찬병원,40891,5282,7064,5251,7064,31,398
힘찬병원,40892,3728,2781,3721,2781,7,209
