정류소명,정류소아이디,총승차건수,총하차건수,승차건수(카드),하차건수(카드),승차건수(현금),일평균승하차건수
(구)국제여객터미널,35051,19,1169,9,1169,10,38
(구)국제여객터미널,35052,1554,20,1544,20,10,50
(구)시민회관사거리,37319,4794,44340,4767,44340,27,1584
(구)시민회관사거리,37326,93402,18325,93294,18325,108,3604
(주)경동세라믹스,89146,611,24,610,24,1,20
(주)경인양행앞,42096,1083,980,1083,980,0,66
(주)경인양행앞,42097,1896,3882,1896,3882,0,186
(주)대한특수금속,39050,1159,68,1159,68,0,39
(주)두남,39135,202,55,202,55,0,8
(주)세모입구(린나이코리아),37585,1283,1916,1283,1916,0,103
(주)세모입구(린나이코리아),40893,318,745,318,745,0,34
(주)스킨이데아,89388,418,414,418,414,0,26
(주)스킨이데아,89389,2209,13,2209,13,0,71
(주)씨피엔텍,39133,532,3404,530,3404,2,126
(주)씨피엔텍,39134,1955,419,1947,419,8,76
(주)창원,39029,3331,2859,3329,2859,2,199
(주)창원,39030,3914,3663,3914,3663,0,244
(주)하나금속,39124,9,67,9,67,0,2
17사단.다임메가타운,40895,1994,4708,1994,4708,0,216
17사단입구,40832,22,464,20,464,2,15
1차풍림아이원,42642,5142,14,5142,14,0,166
2001아울렛,40154,3336,5319,3336,5319,0,279
2001아울렛,40159,30444,12923,30403,12923,41,1398
2001아울렛,40162,10417,21280,10392,21280,25,1022
2001아울렛부평점,40158,4522,2266,4494,2266,28,218
2차풍림아이원,42584,27,11071,27,11071,0,358
3단지,40736,185,1545,185,1545,0,55
3단지관리사무소,40107,1693,430,1693,430,0,68
41번구종점,42174,1951,6229,1950,6229,1,263
510번차고지,36145,947,356,946,356,1,42
540번종점,39470,3343,31,3315,31,28,108
6공단사거리,37577,276,2458,274,2458,2,88
6공단입구,37442,613,877,611,877,2,48
6공단입구,37443,992,1681,992,1681,0,86
8부두,35181,168,1882,165,1882,3,66
8부두,35182,1510,1963,1504,1963,6,112
CJ인천2공장,35591,301,3025,299,3025,2,107
CJ인천2공장,35592,2200,93,2198,93,2,73
E편한세상,42453,3105,1617,3102,1617,3,152
E편한세상,42649,1370,3166,1367,3166,3,146
E편한세상,42726,3179,1577,3176,1577,3,153
GM물류센터,40568,470,1224,470,1224,0,54
GS25편의점,36142,1147,2630,1124,2630,23,121
GS내리주유소,44130,0,1,0,1,0,0
GS내리주유소,44147,2,0,1,0,1,0
GS칼텍스,35168,537,41,530,41,7,18
GS칼텍스,35557,6,2061,6,2061,0,66
GS칼텍스,89220,124,592,124,592,0,23
GS칼텍스,89224,101,1298,101,1298,0,45
GS칼텍스주유소,39814,207,10,207,10,0,7
HD현대인프라코어,36081,651,1532,651,1532,0,70
HD현대인프라코어,36083,2209,1017,2195,1017,14,104
HD현대인프라코어후문,36077,23,747,12,747,11,24
HD현대인프라코어후문,36078,3839,831,3834,831,5,150
JC회관,37383,4002,4188,3993,4188,9,264
JST기술연구소,89491,3,1557,3,1557,0,50
JST기술연구소,89492,546,27,540,27,6,18
KCC아파트,42391,2201,1611,2200,1611,1,122
KG스틸,42008,2317,4249,2308,4249,9,211
KTX광명역4번출구,58057,2858,17,2858,17,0,92
KT부평지사,40381,10218,6734,10142,6734,76,546
KT부평지사,40384,7236,12846,7215,12846,21,647
KT서인천지사,42932,1465,2564,1464,2564,1,129
KT서인천지사,42933,1714,930,1712,930,2,85
KT송도지점,38568,714,449,714,449,0,37
KT온수분국,43523,703,282,703,282,0,31
KT인천공항지사,35095,232,82,231,82,1,10
KT인천공항지사,35109,6825,3356,6806,3356,19,328
KT인천지사,37415,6153,4315,6126,4315,27,337
KT인천지사,39319,8162,4857,8103,4857,59,419
KT중동지사,55081,852,196,847,196,5,33
KT중동지사,55082,148,1198,148,1198,0,43
LG마그나,89029,6367,2563,6361,2563,6,288
LG마그나,89264,3057,5462,3057,5462,0,274
LG물류센터,39043,408,156,408,156,0,18
LG물류센터,39044,76,543,76,543,0,19
LG전자(주),42297,4634,4065,4634,4065,0,280
LH1단지,35494,9268,4467,9265,4467,3,443
LH1단지,35495,4770,6400,4769,6400,1,360
LH49단지행복주택아파트,35768,756,1431,755,1431,1,70
LH49단지행복주택아파트,35769,1942,800,1942,800,0,88
LH7단지,35451,3552,1903,3547,1903,5,175
LH7단지,35452,2264,3424,2264,3424,0,183
LH미추홀3단지,37222,3040,6438,2997,6438,43,305
LH미추홀3단지,37635,6618,2934,6593,2934,25,308
LH웨스턴블루힐정문,89184,1549,3323,1548,3323,1,157
LH웨스턴블루힐정문,89185,4114,3628,4106,3628,8,249
NKG물류센터,89212,275,80,275,80,0,11
SK.GS주유소,89230,1384,1639,1384,1639,0,97
SK.GS주유소,89231,1752,1881,1752,1881,0,117
SKLPG충전사업소,35636,868,27,855,27,13,28
SKLPG충전사업소,35638,33,880,7,880,26,29
SK뷰아파트,42888,1402,5662,1402,5662,0,227
SK뷰아파트,42889,7595,1209,7595,1209,0,284
SK스카이뷰,37601,410,31326,408,31326,2,1023
SK스카이뷰104동,37587,6861,45,6861,45,0,222
SK스카이뷰109동,37607,7519,62,7519,62,0,244
SK인천석유화학,42767,1305,659,1295,659,10,63
SK인천석유화학,42768,401,731,401,731,0,36
SK주유소,42956,257,297,257,297,0,17
SK주유소앞,35287,1378,137,1375,137,3,48
SK주유소앞,35539,69,1339,69,1339,0,45
SK충전소,35085,32,2468,24,2468,8,80
e편한세상 정문,38624,20602,1262,20597,1262,5,705
e편한세상(109동 앞),32062,689,1328,689,1328,0,65
e편한세상(109동앞),38643,1018,497,1018,497,0,48
e편한세상1차(정문),35662,540,1005,539,1005,1,49
e편한세상1차(정문),35663,1435,485,1435,485,0,61
e편한세상계양,41037,14605,3570,14591,3570,14,586
e편한세상계양,41038,4974,14375,4968,14375,6,624
e편한세상영종센텀베뉴정문,35510,1255,4415,1255,4415,0,182
e편한세상영종오션하임,35674,1693,681,1693,681,0,76
e편한세상영종오션하임,35761,641,1704,641,1704,0,75
e편한세상영종하늘도시,35646,476,678,475,678,1,37
e편한세상영종하늘도시,35647,253,384,253,384,0,20
gym80fitness,37081,2632,886,2619,886,13,113
가경공원,89365,1044,545,1044,545,0,51
가구단지사거리,37455,2795,3660,2784,3660,11,208
가구단지사거리,37456,2890,2091,2889,2091,1,160
가구전시장,42072,356,550,356,550,0,29
가구전시장,42074,763,512,761,512,2,41
가나안마을앞,43904,0,15,0,15,0,0
가나안마을앞,43905,36,1,34,1,2,1
가능포,43969,3,5,3,5,0,0
가능포,43970,0,25,0,25,0,0
가림고등학교,42078,11211,13032,11168,13032,43,782
가야,42807,1107,4,1107,4,0,35
가야,42808,25,1235,25,1235,0,40
가오대입구,80033,119,383,114,383,5,16
가오대입구,80034,93,648,92,648,1,23
가원초등학교,42952,5800,4678,5793,4678,7,338
가원초등학교,89118,2748,5301,2739,5301,9,259
가재우물터,35678,15,10,15,10,0,0
가재우물터,35700,6,21,6,21,0,0
가재울사거리,42039,2221,5573,2219,5573,2,251
가재울사거리,42042,8573,4653,8547,4653,26,426
가재울역,42034,2454,3148,2445,3148,9,180
가재울역,42035,3788,2159,3770,2159,18,191
가정(루원시티)역,89050,6435,52441,6435,52441,0,1899
가정(루원시티)역,89051,69694,8713,69694,8713,0,2529
가정(루원시티)역,89075,73866,77961,73812,77961,54,4897
가정(루원시티)역,89078,80341,69755,80296,69755,45,4841
가정3동성당,42226,433,3477,432,3477,1,126
가정LH3단지정문앞,89041,18557,3942,18518,3942,39,725
가정고등학교,42200,11384,4343,11268,4343,116,507
가정고등학교,42203,3297,7993,3280,7993,17,364
가정교,89502,107,1205,98,1205,9,42
가정교,89503,1623,247,1620,247,3,60
가정교차로,89390,357,915,356,915,1,41
가정교차로,89391,308,2490,308,2490,0,90
가정동성당,89102,3206,3730,3202,3730,4,223
가정동성당,89105,2520,1724,2514,1724,6,136
가정보금자리,89119,1464,712,1464,712,0,70
가정보금자리,89120,90,1473,90,1473,0,50
가정여자중학교,42041,928,8176,916,8176,12,293
가정여중입구,89303,897,984,870,984,27,60
가정중앙시장역,42215,1059,1369,1058,1369,1,78
가정중앙시장역,42219,1234,1507,1221,1507,13,88
가정택지삼거리,89385,263,136,263,136,0,12
가정택지삼거리,89386,157,520,157,520,0,21
가정휴먼시아3단지,89186,1349,1630,1349,1630,0,96
가정휴먼시아3단지,89187,1719,1762,1719,1762,0,112
가좌2동행정복지센터,42073,6045,420,5998,420,47,208
가좌2동행정복지센터,42076,135,4930,125,4930,10,163
가좌3동행정복지센터,42075,12365,12617,12309,12617,56,805
가좌4동행정복지센터,42062,5122,6792,5088,6792,34,384
가좌고등학교,42060,15108,11654,15040,11654,68,863
가좌고등학교,42061,5377,8045,5340,8045,37,432
가좌공단,42526,28,9408,23,9408,5,304
가좌공단,42945,7471,267,7467,267,4,249
가좌교회,42055,3289,7558,3278,7558,11,349
가좌교회,42057,3750,3477,3744,3477,6,233
가좌녹지공원,42029,1798,4017,1784,4017,14,187
가좌녹지공원,42030,2291,1744,2277,1744,14,130
가좌농협,42066,8631,6573,8567,6573,64,490
가좌농협,42067,6092,6228,6029,6228,63,397
가좌동차고,42939,2041,262,1966,262,75,74
가좌동차고지,42522,101,1028,24,1028,77,36
가좌두산위브104동앞,42090,4774,3152,4752,3152,22,255
가좌사거리,42043,28,264,20,264,8,9
가좌사거리,42044,491,4838,466,4838,25,171
가좌진주아파트,42100,13738,27890,13688,27890,50,1342
가좌체육공원,42058,7548,1192,7508,1192,40,281
가좌초등학교,42069,3669,4323,3657,4323,12,257
가좌초등학교,42070,3633,2350,3628,2350,5,193
가좌테니스장,37454,2091,1012,2090,1012,1,100
가좌테니스장,37457,804,1141,804,1141,0,62
가좌현대아파트,42130,7923,2153,7912,2153,11,325
가좌현대아파트,42133,654,8047,650,8047,4,280
가좌홈플러스(쌍마아파트),42101,10988,7762,10900,7762,88,604
가좌홈플러스(쌍마아파트),42103,7780,12263,7705,12263,75,646
가좌환경사업소,42631,7628,4746,7618,4746,10,399
가좌환경사업소 북측,89341,220,370,220,370,0,19
가좌환경사업소북측,89342,23,210,23,210,0,7
가천대학교,38270,1119,969,1119,969,0,67
가천대학교,38284,7863,2799,7863,2799,0,343
가천대학교(노인복지회관),38269,716,1044,716,1044,0,56
가천의대,43237,5,21,5,21,0,0
가천의대,43897,2,1,2,1,0,0
가톨릭대,43156,3,2,3,2,0,0
가톨릭대,43325,0,54,0,54,0,1
가현오일뱅크,42734,40,17,40,17,0,1
가현중학교,42722,3027,2170,3001,2170,26,167
가현초교앞(루에블리아파트),89242,2223,3694,2206,3694,17,190
가현초교앞(센트럴타운아파트),89243,5117,1648,5112,1648,5,218
각곡,43602,7,89,7,89,0,3
각곡,43772,134,6,122,6,12,4
간석4거리,39538,251,245,246,245,5,16
간석4동새마을금고,39343,3088,6118,3056,6118,32,296
간석4동새마을금고,39346,3010,2552,2997,2552,13,179
간석4동행정복지센터,39403,3926,7040,3926,7040,0,353
간석4동행정복지센터,39412,4463,2502,4463,2502,0,224
간석금호어울림아파트,39334,24785,12876,24720,12876,65,1214
간석남부역,37429,3840,923,3840,923,0,153
간석남부역,37435,6877,2492,6812,2492,65,302
간석남부역,37529,1660,3409,1660,3409,0,163
간석동용광경로당,39394,953,609,934,609,19,50
간석래미안.자이,39333,16218,17381,16180,17381,38,1083
간석북부역,39806,4439,35,4366,35,73,144
간석북부역,39807,131,2910,77,2910,54,98
간석북부역·우성1차,39368,12739,5027,12739,5027,0,573
간석북부역·우성1차,39370,5762,10355,5762,10355,0,519
간석사거리,39413,12716,9064,12701,9064,15,702
간석사거리,39414,4684,9745,4676,9745,8,465
간석사거리,39430,2478,2532,2445,2532,33,161
간석사거리(상인천중학교),39422,12460,28478,12359,28478,101,1320
간석사거리(상인천중학교),39426,32186,18955,32091,18955,95,1649
간석시장,39434,12751,30841,12664,30841,87,1406
간석시장,39436,56224,30517,56036,30517,188,2798
간석시장,39437,15488,21780,15465,21780,23,1202
간석오거리,39460,15714,13264,15665,13264,49,934
간석오거리,39597,3940,3542,3910,3542,30,241
간석오거리(교원공제조합),39444,35298,28744,35200,28744,98,2065
간석오거리(인천웨딩홀),39406,8225,11870,8180,11870,45,648
간석오거리(인천웨딩홀),39423,34015,20597,33891,20597,124,1761
간석오거리역(7번출구),39447,17104,33248,17091,33248,13,1624
간석오거리역(8번출구),39449,61205,73348,61132,73348,73,4340
간석지구대,39535,499,686,494,686,5,38
간석지구대,39536,530,634,522,634,8,37
간석풍림아파트,92053,736,724,716,724,20,47
간석한신더휴아파트맞은편,37447,2541,516,2541,516,0,98
간재울초등학교,42347,5370,4212,5367,4212,3,309
간촌,43504,18,27,16,27,2,1
간촌,43518,26,16,26,16,0,1
갈산대동아파트,40550,360,697,360,697,0,34
갈산동아아파트,40567,1729,1611,1728,1611,1,107
갈산동입구,40622,38,3235,38,3235,0,105
갈산동천주교회,40652,958,5106,958,5106,0,195
갈산동천주교회맞은편,40650,6564,5214,6562,5214,2,379
갈산두산아파트,40544,4452,6006,4449,6006,3,337
갈산사거리,40631,2699,5073,2699,5073,0,250
갈산사거리,40634,3334,4961,3334,4961,0,267
갈산새마을금고,40635,8353,2173,8353,2173,0,339
갈산시장,40628,6977,6589,6973,6589,4,437
갈산시장.갈산도서관,40629,2397,5889,2397,5889,0,267
갈산역,40601,35770,12223,35767,12223,3,1548
갈산역,40602,10157,42051,10151,42051,6,1684
갈산역(1번출구),40604,21541,6714,21488,6714,53,911
갈산역(부평4공단)4번출구,40606,5997,16537,5982,16537,15,726
갈산주공1단지,40578,3012,2506,3012,2506,0,178
갈산주공1단지105동,40813,4228,2390,4225,2390,3,213
갈산주공2단지,40562,497,1134,497,1134,0,52
갈산주공2단지,40577,3599,7276,3593,7276,6,350
갈산태화아파트,40542,579,1210,579,1210,0,57
갈산태화아파트,40664,4944,934,4944,934,0,189
갈산태화아파트,40666,289,1569,289,1569,0,59
갈산태화아파트,40667,677,3018,677,3018,0,119
갈월초등학교,40531,141,1027,141,1027,0,37
갈현경로당,41491,58,325,58,325,0,12
갈현경로당앞,41607,166,60,166,60,0,7
갈현교,41608,9,2,9,2,0,0
갈현교,41609,0,10,0,10,0,0
갈현교입구,41492,145,30,145,30,0,5
갈현교입구,41617,7,172,7,172,0,5
갈현동마을,41351,658,638,656,638,2,41
갈현동마을,41352,204,954,203,954,1,37
갑곶돈대.강화전쟁박물관,43365,9,6,9,6,0,0
갑곶돈대.강화전쟁박물관,43728,2,17,2,17,0,0
갑곶돈대입구,43367,6,18,6,18,0,0
갑곶돈대입구,43726,14,5,13,5,1,0
갑륭초교,43374,1,1,1,1,0,0
갑륭초교,43724,9,167,9,167,0,5
갑문,35125,9,505,9,505,0,16
갑문,35504,189,6,189,6,0,6
강남시장,42172,19364,13340,19250,13340,114,1054
강남시장,42173,11750,11391,11707,11391,43,746
강남역도시에빛,31076,3744,6220,3744,6220,0,321
강남역서초현대타워앞,31016,43978,27794,43978,27794,0,2315
강남중교,43213,154,31,154,31,0,5
강남중교,43278,10,199,10,199,0,6
강서중학교,43660,9,132,8,132,1,4
강서중학교,43898,176,5,168,5,8,5
강인여객,40020,1065,1424,1062,1424,3,80
강인여객,40022,1129,828,1128,828,1,63
강화갯벌장어,43633,9,0,8,0,1,0
강화갯벌장어,43671,0,24,0,24,0,0
강화경찰서,43209,215,32,201,32,14,7
강화경찰서,43624,5,218,5,218,0,7
강화고등학교,43564,6,31,6,31,0,1
강화고등학교,43761,93,34,93,34,0,4
강화군 행복센터,43055,123,1668,120,1668,3,57
강화군 행복센터,43056,2,180,2,180,0,5
강화군노인문화센터,90373,2,13,2,13,0,0
강화군노인문화센터,90374,10,15,10,15,0,0
강화군청,43065,3200,862,3069,862,131,131
강화군청,43108,754,2506,740,2506,14,105
강화루지.강남상회,43150,86,71,86,71,0,5
강화루지.강남상회,43250,46,123,45,123,1,5
강화마니산,43001,29,58,28,58,1,2
강화마니산,43002,441,171,437,171,4,19
강화문화원.종합전시관,43097,2,32,2,32,0,1
강화문화원.종합전시관,43098,48,553,47,553,1,19
강화병원,43088,41,1518,33,1518,8,50
강화병원,43089,864,46,862,46,2,29
강화산단,90123,0,12,0,12,0,0
강화산단입구,90096,5,14,5,14,0,0
강화산단입구,90097,9,1,9,1,0,0
강화산성서문,43080,6,29,6,29,0,1
강화산성서문,43081,11,46,11,46,0,1
강화서문,43063,634,313,632,313,2,30
강화서문,43064,276,457,261,457,15,23
강화수양관앞,43467,48,26,48,26,0,2
강화수양관앞,43732,16,20,16,20,0,1
강화슈퍼,43066,600,1067,596,1067,4,53
강화슈퍼,43068,1391,462,1310,462,81,59
강화실버케어스앞,43975,12,110,12,110,0,3
강화실버케어스앞,43976,31,55,29,55,2,2
강화여자중학교,90334,0,21,0,21,0,0
강화역사박물관(고인돌),43601,306,21,298,21,8,10
강화역사박물관(고인돌),43670,17,368,15,368,2,12
강화장례식장,43918,1343,90,1303,90,40,46
강화장례식장,43946,37,1573,29,1573,8,51
강화중학교,43207,24,45,21,45,3,2
강화중학교,43623,7,54,7,54,0,1
강화터미널,43058,0,1,0,1,0,0
강화터미널,43096,44865,1357,43635,1357,1230,1491
개항동 어울터,35197,9088,1660,9044,1660,44,346
개항동 어울터,35198,2203,8974,2198,8974,5,360
개화2치안센터,25023,37,1545,36,1545,1,51
개화2치안센터,25024,1896,38,1895,38,1,62
개화역1번출구.개화검문소,25030,149,6389,148,6389,1,210
개화역1번출구.개화검문소,25031,2110,242,2109,242,1,75
개화역광역환승센터,25182,1182,2073,1182,2073,0,105
갤러리84입구,35666,129,10,126,10,3,4
갤러리84입구,35667,72,138,72,138,0,6
갯벌슈퍼,43410,1,19,1,19,0,0
갯벌슈퍼,43513,9,13,9,13,0,0
거북시장,42132,13223,11547,13107,11547,116,799
거북시장,42136,12427,10937,12359,10937,68,753
거산정공.(주)록키,39137,1426,2187,1426,2187,0,116
거잠포선착장,35302,74,198,74,198,0,8
거잠포선착장,35303,106,54,106,54,0,5
거잠포회센터,35588,64,12,62,12,2,2
건설기술교육원,39353,6102,11045,6099,11045,3,553
건설기술교육원,39354,5190,3962,5188,3962,2,295
건영아파트,38069,16245,40722,16224,40722,21,1837
건일아파트,43015,424,283,418,283,6,22
건일아파트,43094,303,300,303,300,0,19
건지사거리,42882,93,0,93,0,0,3
건지사거리,42883,0,250,0,250,0,8
건평,43168,52,50,51,50,1,3
건평,43186,1,42,1,42,0,1
건평리,43187,47,8,47,8,0,1
건평리,43651,2,47,2,47,0,1
건평마을회관,43594,11,42,9,42,2,1
건평입구,43170,1,10,1,10,0,0
건평입구,43331,2,14,2,14,0,0
걸포북변역,35560,44,3925,44,3925,0,128
걸포북변역,35610,2132,98,2132,98,0,71
걸포사거리.우리병원,35561,191,275,191,275,0,15
검단1차피오레,89457,404,188,404,188,0,19
검단1차피오레,89458,35,549,35,549,0,18
검단LH행복주택,89408,12884,3709,12884,3709,0,535
검단공구상가,89053,55,705,55,705,0,24
검단공구상가,89065,438,202,438,202,0,20
검단금호아파트,42557,1,116,1,116,0,3
검단금호아파트,42558,224,463,224,463,0,22
검단노인복지관,42695,157,549,148,549,9,22
검단농기구센터,89316,120,2,120,2,0,3
검단농기구센터,89324,5,183,5,183,0,6
검단농협,42432,26006,8959,25987,8959,19,1127
검단농협,42434,5229,14483,5217,14483,12,635
검단대성베르힐,89467,1539,270,1539,270,0,58
검단동행정복지센터(검단고교),42441,3814,8228,3804,8228,10,388
검단동행정복지센터(검단고교),42445,4325,4468,4323,4468,2,283
검단디에트르리버파크,89476,842,4277,839,4277,3,165
검단디에트르리버파크,89477,3160,774,3154,774,6,126
검단로제비앙라포레,89483,2497,14,2496,14,1,81
검단로제비앙라포레,89484,11,1026,11,1026,0,33
검단로지스틱스파크,41339,979,269,969,269,10,40
검단로지스틱스파크,42395,213,2945,211,2945,2,101
검단메가박스,42383,1848,1864,1842,1864,6,119
검단메가박스,42384,422,1033,422,1033,0,46
검단모아미래도엘리트,89466,531,2355,531,2355,0,93
검단모아엘가그랑데아파트,42483,7081,1363,7075,1363,6,272
검단사거리역,42419,15036,15002,15015,15002,21,968
검단사거리역,42426,1826,8460,1818,8460,8,331
검단사거리역,42427,7791,2939,7753,2939,38,346
검단사거리역,42537,11419,13371,11395,13371,24,799
검단산업단지(코뿔소),42805,102,1,102,1,0,3
검단산업단지(코뿔소),42806,2,58,1,58,1,1
검단소방서,42428,1157,4594,1147,4594,10,185
검단소방서,42431,306,2135,303,2135,3,78
검단신도시예미지더시그너스,89415,969,700,969,700,0,53
검단신도시예미지더시그너스,89416,484,495,484,495,0,31
검단신도시우미린리버포레,89409,5452,11743,5441,11743,11,554
검단신안인스빌어반퍼스트,89511,1491,29,1491,29,0,49
검단신안인스빌어반퍼스트,89512,58,1521,58,1521,0,50
검단오류공단,42702,18,516,18,516,0,17
검단오류공단,42703,275,18,275,18,0,9
검단오류역,89057,6031,739,6026,739,5,218
검단오류역,89060,506,5989,503,5989,3,209
검단오류역우방아이유쉘,89067,559,1000,559,1000,0,50
검단오류역우방아이유쉘,89068,1250,275,1246,275,4,49
검단오류풍림아이원,89251,148,403,148,403,0,17
검단오류풍림아이원,89252,452,181,452,181,0,20
검단우미린파크뷰1단지,89499,1193,64,1193,64,0,40
검단우미린파크뷰1단지,89500,97,260,97,260,0,11
검단우미린파크뷰2단지,89469,3289,1511,3289,1511,0,154
검단우미린파크뷰2단지,89501,1738,2436,1738,2436,0,134
검단우방아이유쉘아파트,42688,277,404,268,404,9,21
검단원흥아파트,42400,1630,987,1629,987,1,84
검단원흥아파트,42401,1159,2532,1158,2532,1,119
검단지식산업센타,89054,6907,164,6895,164,12,228
검단지식산업센타,89063,181,4640,178,4640,3,155
검단초등학교,42475,8548,3475,8522,3475,26,387
검단초등학교,42482,3469,6141,3468,6141,1,310
검단초등학교,89332,103,129,95,129,8,7
검단초등학교,89333,112,153,107,153,5,8
검단출장소,42423,14454,11222,14450,11222,4,828
검단출장소,42424,4221,9360,4215,9360,6,438
검단탑종합병원,42877,407,521,407,521,0,29
검단하나아파트,42421,2015,481,2012,481,3,80
검단하나아파트,42422,370,447,363,447,7,26
검문소,43662,4,5,3,5,1,0
검문소,43812,5,59,5,59,0,2
검문소,90042,1,4,1,4,0,0
검문소,90043,28,110,27,110,1,4
검바위역,42348,3761,960,3746,960,15,152
검바위역,42349,1051,4066,1048,4066,3,165
검암경서동행정복지센터,42352,1768,5844,1767,5844,1,245
검암경서동행정복지센터,42353,6063,1875,6059,1875,4,256
검암사거리,42356,2383,3595,2379,3595,4,192
검암사거리,42357,4169,2060,4160,2060,9,200
검암사거리,42358,6424,1940,6422,1940,2,269
검암역(시내방면),42364,12168,537,12141,537,27,409
검암역(원당방면),42363,3662,27931,3644,27931,18,1019
검암역.서해그랑블아파트,42360,5599,5622,5599,5622,0,361
검암역로열파크씨티푸르지오1단지,89167,10031,46,9966,46,65,325
검암역로열파크씨티푸르지오1단지,89168,19,8786,14,8786,5,284
검암역로열파크씨티푸르지오2단지,89169,524,63,516,63,8,18
검암역로열파크씨티푸르지오2단지,89170,35,5064,34,5064,1,164
검암역입구,42851,20591,8087,20584,8087,7,925
검암역입구,42852,9026,12510,9020,12510,6,694
검암역입구(시천교밑),89250,11953,3013,11953,3013,0,482
검암중학교,42359,3948,1801,3948,1801,0,185
검암중학교,42362,2355,2880,2355,2880,0,168
검암초등학교,42361,417,5707,417,5707,0,197
겐트대학교글로벌캠퍼스,38769,36,1,36,1,0,1
겐트대학교글로벌캠퍼스,38770,44,503,44,503,0,17
경기국제통상고.포도마을뉴서울.중앙공원,55042,621,1691,620,1691,1,74
경기국제통상고.포도마을뉴서울.중앙공원,55043,1219,990,1207,990,12,71
경기도학생교육원,43162,0,99,0,99,0,3
경기도학생교육원,43222,203,24,203,24,0,7
경기주유소,43051,66,395,66,395,0,14
경남1차,40343,8511,417,8423,417,88,288
경남1차아파트,40376,13385,6909,13367,6909,18,654
경남2차,40305,8960,71,8868,71,92,291
경남아너스빌,42099,2971,1542,2969,1542,2,145
경남아너스빌,42102,1509,2493,1508,2493,1,129
경남아너스빌아파트,42110,4990,2981,4983,2981,7,257
경남아너스빌아파트,42111,1686,2897,1679,2897,7,147
경남아파트,35143,7564,2543,7540,2543,24,326
경남아파트,35147,1365,2785,1355,2785,10,133
경남아파트,38281,8148,7403,8135,7403,13,501
경남아파트,41011,14993,3897,14934,3897,59,609
경남아파트,41014,3883,7948,3879,7948,4,381
경남아파트,42332,6901,3618,6896,3618,5,339
경남아파트,42334,3278,6625,3278,6625,0,319
경남아파트308동앞,40334,48,5176,46,5176,2,168
경남아파트311동앞,40300,26,5900,26,5900,0,191
경남아파트313동앞,40287,71,9534,40,9534,31,309
경동택배,89315,97,3,97,3,0,3
경동택배,89325,0,22,0,22,0,0
경명초등학교,89216,1397,582,1397,582,0,63
경명초등학교,89277,5166,7817,5166,7817,0,418
경명초등학교,89278,4416,5877,4416,5877,0,332
경방신약,39136,4784,1272,4783,1272,1,195
경방신약,39138,2462,8460,2462,8460,0,352
경복예식장,39399,10021,4963,9944,4963,77,483
경서농원,42333,78,513,78,513,0,19
경서농원,42335,41,1016,41,1016,0,34
경서지구입구,42303,1017,5465,1017,5465,0,209
경서지구입구,42671,2379,2511,2379,2511,0,157
경서지구입구,42672,4034,2742,4034,2742,0,218
경서초등학교,42569,3962,2552,3962,2552,0,210
경서초등학교,42570,2669,2705,2667,2705,2,173
경신마을,39646,157,143,157,143,0,9
경신마을,39982,91,839,91,839,0,30
경신아파트,41216,1782,991,1780,991,2,89
경신아파트,41223,1710,3280,1701,3280,9,160
경연초중학교,89271,6262,4127,6262,4127,0,335
경연초중학교,89272,3039,5105,3039,5105,0,262
경연초중학교·청라센텀로제비앙,89286,2643,993,2643,993,0,117
경연초중학교·호반베르디움6차,89285,1860,1929,1857,1929,3,122
경인계량소,42549,806,5,801,5,5,26
경인계량소,42550,2,529,2,529,0,17
경인교대.부평향교,41138,938,1065,931,1065,7,64
경인교대.부평향교,41139,845,925,845,925,0,57
경인교대역입구,41428,7895,6762,7872,6762,23,472
경인교대역입구,41429,6911,8468,6896,8468,15,496
경인교회앞,40077,932,3183,921,3183,11,132
경인방송,37003,131,107,131,107,0,7
경인방송,37004,56,308,56,308,0,11
경인산업,39688,716,1394,716,1394,0,68
경인아라뱃길여객터미널,42869,270,10,269,10,1,9
경인여대,41277,6193,9646,6184,9646,9,510
경인여대,41278,3359,4178,3356,4178,3,243
경인특장,42547,279,2,276,2,3,9
경인항다목적부두,89151,86,2,85,2,1,2
경인항다목적부두,89152,1,136,1,136,0,4
경전말,43934,40,2,35,2,5,1
경제자유구역청,38514,1861,2350,1861,2350,0,135
경제자유구역청,38515,2803,3610,2801,3610,2,206
경진브로아,39042,939,1181,939,1181,0,68
경흥빌라,43372,471,13,455,13,16,15
경흥빌라,43616,5,197,5,197,0,6
경희유치원앞,39991,146,465,146,465,0,19
경희유치원앞,39992,90,81,90,81,0,5
계량소,40195,2114,274,2101,274,13,77
계룡리슈빌,55225,4132,946,4132,946,0,163
계산공고,41167,2981,4007,2944,4007,37,225
계산공고,41170,4916,7327,4906,7327,10,394
계산공고앞,41169,2713,1983,2703,1983,10,151
계산국민체육센터,41276,1647,2861,1644,2861,3,145
계산국민체육센터,41613,2326,2179,2305,2179,21,145
계산동수협,41533,3429,4233,3419,4233,10,247
계산동아아파트,41231,185,3,185,3,0,6
계산동우체국,41427,7067,3643,7059,3643,8,345
계산삼거리,41196,337,253,337,253,0,19
계산삼거리(신도브래뉴),41199,10100,9092,10095,9092,5,619
계산삼거리(신도브래뉴),41201,3907,7653,3902,7653,5,372
계산시장,41176,3643,4648,3638,4648,5,267
계산여고,41576,694,702,691,702,3,45
계산여자고등학교,41221,11,214,11,214,0,7
계산여자고등학교,41224,900,984,894,984,6,60
계산역,41247,6461,4456,6436,4456,25,352
계산역,41371,5620,1181,5620,1181,0,219
계산역,41426,31303,21293,31287,21293,16,1696
계산역,41431,23863,31146,23841,31146,22,1774
계산우체국,41430,10171,12391,10161,12391,10,727
계산주공아파트,41423,12768,14239,12745,14239,23,871
계산중학교,41577,145,28,145,28,0,5
계양1동주민자치센터,41476,7135,1821,7109,1821,26,288
계양1동주민자치센터,41520,728,7088,722,7088,6,252
계양3동행정복지센터,41525,759,1188,759,1188,0,62
계양3동행정복지센터,41526,988,729,988,729,0,55
계양CGV,41140,4176,3991,4176,3991,0,263
계양경찰서,41184,10447,9314,10447,9314,0,637
계양경찰서,41185,6744,9731,6744,9731,0,531
계양경찰서,41195,20547,5459,20421,5459,126,838
계양경찰서·계양구청,41194,4509,16880,4485,16880,24,689
계양구의회,41123,5419,4845,5400,4845,19,331
계양구의회,41124,5038,5495,4998,5495,40,339
계양구청,41177,4457,4339,4456,4339,1,283
계양구청,41180,7363,9722,7349,9722,14,551
계양구청,41188,3977,1902,3976,1902,1,189
계양구청,41197,11,2608,11,2608,0,84
계양구청앞,41204,7630,4180,7579,4180,51,380
계양도서관,41251,5308,9317,5272,9317,36,471
계양문화회관,41248,1561,945,1561,945,0,80
계양문화회관,41255,2367,3991,2349,3991,18,205
계양산성박물관,41285,1095,1484,1089,1484,6,83
계양산성박물관,41286,776,1766,773,1766,3,82
계양산장미원 입구(계산동자연풀장),41186,852,1013,852,1013,0,60
계양산장미원 입구(계산동자연풀장),41189,536,954,536,954,0,48
계양산전통시장,41297,856,4656,841,4656,15,177
계양산전통시장,41298,4544,1470,4491,1470,53,194
계양산전통시장,41306,17145,16840,17100,16840,45,1096
계양산지구대,41281,880,1326,877,1326,3,71
계양산지구대,41282,842,1119,838,1119,4,63
계양새마을금고,41094,1506,1437,1502,1437,4,94
계양새마을금고,41097,1531,2103,1523,2103,8,117
계양세무서,41054,1640,1063,1636,1063,4,87
계양세무서,41058,833,1440,831,1440,2,73
계양센트레빌1단지,41550,4292,4764,4274,4764,18,292
계양센트레빌1단지,41627,1173,496,1173,496,0,53
계양센트레빌1단지,41628,168,829,168,829,0,32
계양센트레빌1단지(111동앞),41551,5896,4631,5894,4631,2,339
계양센트레빌2단지,41625,396,918,396,918,0,42
계양여성회관,41404,3250,4170,3237,4170,13,239
계양역,41357,175310,69344,175236,69344,74,7892
계양역,41358,62237,139658,62183,139658,54,6512
계양역(귤현역방면),41659,6104,369,6027,369,77,208
계양임광그대가아파트,41118,3617,263,3572,263,45,125
계양종합사회복지관,41120,466,1171,466,1171,0,52
계양종합사회복지관,41121,1128,574,1114,574,14,54
계양중학교,41340,2311,869,2292,869,19,102
계양중학교,41341,1473,5995,1458,5995,15,240
계양체육관(벨로드롬경기장),41440,3709,1233,3702,1233,7,159
계양체육관(벨로드롬경기장),41666,252,1123,244,1123,8,44
계양체육관(아시아드양궁장),41454,715,693,707,693,8,45
계양체육관(아시아드양궁장),41455,2030,909,2027,909,3,94
계양체육관(아시아드양궁장),41567,3130,813,3130,813,0,127
계양체육관(아시아드양궁장),41568,958,5363,958,5363,0,203
계양효성해링턴플레이스,41669,46,1780,46,1780,0,58
고구1리입구,90006,43,8,43,8,0,1
고구1리입구,90007,2,34,2,34,0,1
고구2리마을회관입구,90014,8,117,8,117,0,4
고구2리마을회관입구,90015,118,4,114,4,4,3
고구저수지,90008,3,29,3,29,0,1
고구저수지,90009,13,2,13,2,0,0
고구촌,90012,0,30,0,30,0,0
고구촌,90013,40,0,40,0,0,1
고능2리 종점,90372,2,6,0,6,2,0
고능2리능촌마을회관,90371,0,4,0,4,0,0
고능리공소,90208,68,72,65,72,3,4
고능리입구,43291,10,38,10,38,0,1
고능리입구,43534,74,7,74,7,0,2
고다니마을9단지,80362,126,76,125,76,1,6
고려산업,39486,677,1125,677,1125,0,58
고려양행,39111,1252,1568,1252,1568,0,90
고려저수지입구,43249,24,83,24,83,0,3
고려저수지입구,43486,65,30,64,30,1,3
고비고개정상,43569,5,2,5,2,0,0
고비고개정상,43844,0,15,0,15,0,0
고산마을입구,90016,8,22,8,22,0,0
고산마을입구,90017,37,4,31,4,6,1
고산촌,43544,146,48,131,48,15,6
고산촌,43779,83,109,81,109,2,6
고상골,43269,0,50,0,50,0,1
고상골,43382,67,6,67,6,0,2
고상골입구,43266,87,6,83,6,4,3
고상골입구,43552,7,84,7,84,0,2
고속터미널,31017,11773,338,11773,338,0,390
고속터미널,31018,561,18465,561,18465,0,613
고시기(가재골),43770,3,0,3,0,0,0
고시기(가재골),90126,0,5,0,5,0,0
고염나무골,35473,20,233,20,233,0,8
고염나무골,35474,299,20,298,20,1,10
고인돌입구,43550,0,31,0,31,0,1
고인돌체육관앞,90045,99,427,95,427,4,16
고인돌체육관앞,90046,438,93,435,93,3,17
고잔고등학교,39691,321,2658,321,2658,0,96
고잔마을,43284,71,0,69,0,2,2
고잔마을,43532,0,41,0,41,0,1
고창마을.KCC,80328,338,210,338,210,0,17
고창촌,43076,31,90,30,90,1,3
고창촌입구,43166,1,1,1,1,0,0
고창촌입구,43345,0,20,0,20,0,0
고천3리마을회관,43341,102,7,95,7,7,3
고천3리마을회관,43574,13,68,9,68,4,2
고천5리마을회관,90341,8,0,7,0,1,0
고천5리마을회관,90345,1,6,1,6,0,0
고천교,43339,55,51,55,51,0,3
고천교,43849,74,30,70,30,4,3
고천당,90420,7,5,6,5,1,0
고천당,90421,10,1,10,1,0,0
고촌역,80061,3283,849,3283,849,0,133
고촌역,80062,720,5756,720,5756,0,208
고합아파트,70036,143,132,141,132,2,8
고향산천,43464,8,6,8,6,0,0
고향산천,43610,15,11,13,11,2,0
곡촌,43427,15,32,15,32,0,1
곡촌,43457,68,19,64,19,4,2
곡촌,43789,66,47,56,47,10,3
곡촌,43816,2,68,2,68,0,2
곤능,43197,2,60,2,60,0,2
곤능,43319,41,0,39,0,2,1
골드클래스,42936,192,796,190,796,2,31
공개마을,90195,15,4,11,4,4,0
공개마을,90196,5,19,5,19,0,0
공구상가,36092,443,1744,432,1744,11,70
공구상가.간동입구,80021,1234,106,1234,106,0,43
공군8547부대앞,35718,60,49,58,49,2,3
공군8547부대앞,35719,5,151,5,151,0,5
공군회관,19255,86,3,86,3,0,2
공군회관,20107,8,242,8,242,0,8
공단공구상가,92048,0,27,0,27,0,0
공단공원앞,42739,144,202,144,202,0,11
공단공원앞,42740,293,90,293,90,0,12
공단본부,42270,255,783,255,783,0,33
공단본부,42756,2733,559,2732,559,1,106
공단본부,42757,685,2517,684,2517,1,103
공단사거리,42995,6,655,6,655,0,21
공단사거리,42996,1169,7,1169,7,0,37
공단사거리,89069,13,266,13,266,0,9
공단사거리,89070,216,522,216,522,0,23
공단소방서,39062,1484,3572,1484,3572,0,163
공단시장,37426,2449,5223,2443,5223,6,247
공단시장,37427,7637,3107,7632,3107,5,346
공단오거리,40565,1793,740,1785,740,8,81
공단오거리,40566,376,2653,375,2653,1,97
공단유통상가,42940,19,1060,19,1060,0,34
공단유통상가,42941,1042,38,1042,38,0,34
공단자동차,42022,1668,1845,1666,1845,2,113
공단치안센터,37444,1435,896,1435,896,0,75
공단치안센터,37445,287,1533,287,1533,0,58
공단회관,39119,1432,3476,1431,3476,1,158
공단회관,39123,3028,1158,3027,1158,1,135
공덕오거리,14149,431,6,431,6,0,14
공설운동장,43091,11,507,11,507,0,16
공설운동장,43092,246,106,241,106,5,11
공수부대입구,92069,81,69,81,69,0,4
공숙입구,43290,2,48,2,48,0,1
공숙입구,43490,42,53,41,53,1,3
공영산업,89148,19,899,18,899,1,29
공작아파트,39479,2089,3496,2073,3496,16,180
공작아파트,39480,3079,4860,3068,4860,11,256
공장단지입구,42555,266,74,266,74,0,10
공촌마을,42323,4602,3036,4589,3036,13,246
공촌마을,42598,2369,4183,2357,4183,12,211
공촌사거리,42324,19597,11087,19597,11087,0,989
공촌사거리,42330,16734,18079,16730,18079,4,1123
공촌사거리,42331,812,633,812,633,0,46
공촌사거리(한국아파트),42322,4210,5326,4210,5326,0,307
공촌유수지체육공원,89478,116,1077,116,1077,0,38
공촌유수지체육공원,89479,445,127,445,127,0,18
공촌정수장,42340,159,121,159,121,0,9
공촌정수장,42341,84,242,84,242,0,10
공항고등학교,35116,2729,772,2728,772,1,112
공항고속도로진입(미정차),35644,1,0,1,0,0,0
공항교회앞,35123,1916,2394,1915,2394,1,139
공항신도시(메디컬사거리),35258,855,1449,855,1449,0,74
공항중학교,35117,1203,1402,1201,1402,2,84
공항초등학교,35087,156,395,156,395,0,17
관곡마을,90104,0,5,0,5,0,0
관곡마을,90105,11,0,11,0,0,0
관광밸트입구,43874,0,1,0,1,0,0
관광밸트입구,43875,1,0,1,0,0,0
관교노인복지관·승학초등학교,37679,767,1129,759,1129,8,61
관교여자중학교,37226,8109,7205,8046,7205,63,494
관교여자중학교,37229,2005,2422,1991,2422,14,142
관교여자중학교,37231,2244,2701,2206,2701,38,159
관교중학교,37200,261,952,260,952,1,39
관교중학교(약수터),37202,4323,6666,4255,6666,68,354
관교중학교(약수터),37203,9703,5939,9592,5939,111,504
관리공단본부,42720,512,113,512,113,0,20
관창마을,35252,1547,971,1547,971,0,81
관창마을,35253,1641,2116,1641,2116,0,121
광명아파트,37434,13491,6549,13485,6549,6,646
광명아파트,39348,7104,13735,7104,13735,0,672
광명아파트,39835,13,968,12,968,1,31
광명아파트,40590,2611,1015,2611,1015,0,116
광명아파트,40817,7753,1619,7735,1619,18,302
광명아파트,41096,679,2295,679,2295,0,95
광명아파트,41098,2325,900,2315,900,10,104
광명아파트,41108,14697,20785,14681,20785,16,1144
광명아파트,41448,2434,8673,2432,8673,2,358
광명역IC출입(미정차),53042,8,0,8,0,0,0
광명항,35708,38,0,38,0,0,1
광명항,35714,706,595,702,595,4,41
광명항(샘꾸미),35730,59,0,50,0,9,1
광성보,43674,18,97,18,97,0,3
광성오리,43128,3,0,3,0,0,0
광성오리,43862,1,14,1,14,0,0
광일아파트,40855,3725,1163,3718,1163,7,157
광일아파트,40874,1995,3613,1995,3613,0,180
교대역,31013,21369,19838,21369,19838,0,1329
교대입구,41141,1837,2887,1798,2887,39,152
교대입구,41142,3066,1982,3055,1982,11,162
교대후문,41362,1270,341,1269,341,1,51
교대후문,41363,364,2328,364,2328,0,86
교동중고후문,90024,1,92,1,92,0,3
교동중고후문,90025,87,10,82,10,5,3
교보생명,37357,28664,106885,28608,106885,56,4372
교산교회,43496,38,7,31,7,7,1
교산교회,43719,5,20,3,20,2,0
교산리입구,43694,33,29,30,29,3,2
교산리입구,43748,35,10,25,10,10,1
교산상회앞,43494,2,7,2,7,0,0
교산상회앞,43715,0,2,0,2,0,0
교육개발원입구,31005,779,16,779,16,0,25
교육개발원입구,31006,13,781,13,781,0,25
교육연수원,35482,1154,678,1153,678,1,59
교통방송사거리,37538,904,2569,902,2569,2,112
교통방송사거리,37539,775,991,775,991,0,56
교통연수원,41191,809,2569,809,2569,0,108
교통연수원,41192,2508,1387,2508,1387,0,125
교회앞,43216,7,13,7,13,0,0
교회앞,43309,18,14,15,14,3,1
교회앞,43430,16,23,16,23,0,1
교회앞,43818,16,26,16,26,0,1
교회앞,90338,6,14,5,14,1,0
교회앞,90348,16,0,15,0,1,0
구검문소,43196,1,65,1,65,0,2
구검문소,43622,131,2,130,2,1,4
구능재,90193,14,11,13,11,1,0
구능재,90194,11,17,9,17,2,0
구도일주유소,40902,80,1388,79,1388,1,47
구두물입구,35219,338,306,338,306,0,20
구래리,80006,408,1549,405,1549,3,63
구래리,80007,1733,556,1719,556,14,73
구래역,80337,10018,21169,9990,21169,28,1006
구래역,80338,22816,10237,22751,10237,65,1066
구렁목,43950,169,3,165,3,4,5
구렁목,43951,6,92,4,92,2,3
구름다리,35735,4,98,4,98,0,3
구름다리,35736,5,3,5,3,0,0
구반포역.세화고등학교,31031,1000,29,1000,29,0,33
구봉도입구,62035,33,262,33,262,0,9
구봉도입구,62037,236,44,230,44,6,9
구북성초교,43506,8,13,8,13,0,0
구북성초교,43656,6,10,6,10,0,0
구산사거리,40233,652,412,648,412,4,34
구산사거리,40842,325,19511,303,19511,22,639
구산사거리,40843,3805,7327,3785,7327,20,359
구산중학교,40518,731,909,712,909,19,52
구선택초교,43239,9,3,9,3,0,0
구선택초교,43896,1,2,1,2,0,0
구월1동행정복지센터,39967,989,3,989,3,0,32
구월1동행정복지센터,39981,1,407,1,407,0,13
구월2동행정복지센터,39586,2973,358,2969,358,4,107
구월2동행정복지센터,39607,246,2499,241,2499,5,88
구월도매전통시장,39192,21474,16452,21391,16452,83,1223
구월도매전통시장,39193,23641,34755,23615,34755,26,1883
구월동로데오거리,39195,5093,1117,5090,1117,3,200
구월동우체국,39211,4208,13150,4190,13150,18,559
구월동팬더아파트,39237,8009,8345,7977,8345,32,527
구월동팬더아파트,39238,9561,6810,9528,6810,33,528
구월서초등학교,39204,8442,6914,8404,6914,38,495
구월서초등학교,39205,5925,5996,5918,5996,7,384
구월아시아드1단지,39912,683,3,682,3,1,22
구월아시아드1단지,39913,3,131,0,131,3,4
구월아시아드5단지정문,39883,2585,6024,2570,6024,15,277
구월아시아드5단지후문,39881,2465,4721,2461,4721,4,231
구월아시아드6단지,39885,26097,8026,26089,8026,8,1100
구월아시아드6단지,39886,7338,19139,7326,19139,12,854
구월아시아드7단지,39892,2838,3960,2836,3960,2,219
구월아시아드8단지,39891,5100,1879,5096,1879,4,225
구월아시아드8단지,39948,58,475,58,475,0,17
구월아시아드8단지,39949,40,192,40,192,0,7
구월아시아드선수촌아파트,39202,785,740,785,740,0,49
구월아시아드선수촌아파트,39203,674,1830,674,1830,0,80
구월아시아드은빛호수공원,39914,9303,6214,9292,6214,11,500
구월아시아드은빛호수공원,39915,6998,5826,6983,5826,15,413
구월우체국,39213,8753,7921,8723,7921,30,537
구월중학교,39281,28167,19287,27999,19287,168,1530
구월중학교,39286,19364,29824,19293,29824,71,1586
구월체육공원,39384,3612,5006,3605,5006,7,278
구월초등학교,39832,1672,3715,1669,3715,3,173
구월초등학교,39833,3432,2120,3414,2120,18,179
구월한내들퍼스티지,39882,4769,2022,4768,2022,1,219
구장수파출소,39375,613,538,613,538,0,37
구재이,43282,50,8,48,8,2,1
구재이,43551,4,17,4,17,0,0
구정슈퍼앞,35498,8,68,8,68,0,2
구정슈퍼앞,35587,88,14,87,14,1,3
구정정미소,90284,0,8,0,8,0,0
구중학교앞,44119,10,2,8,2,2,0
구중학교앞,44148,4,0,2,0,2,0
구하1리입구,43259,1,27,1,27,0,0
구하1리입구,43562,128,1,105,1,23,4
구하2리마을회관,43254,49,0,48,0,1,1
구하2리마을회관,43256,74,1,69,1,5,2
구하2리마을회관,43373,0,51,0,51,0,1
구하2리마을회관,43559,0,57,0,57,0,1
국궁장앞,70151,33,170,32,170,1,6
국립생물자원관,89111,166,532,166,532,0,22
국립생물자원관입구,42741,332,497,332,497,0,26
국립인천공항검역소,35430,21,237,20,237,1,8
국립인천공항검역소,35431,43,94,43,94,0,4
국민건강보험 인천부평지사,40620,1157,4308,1151,4308,6,176
국민건강보험 인천부평지사,40621,3550,1553,3542,1553,8,164
국민건강보험남부지사,37274,12980,11778,12918,11778,62,798
국민은행,38148,2109,6101,2108,6101,1,264
국민은행,38149,6040,2422,6030,2422,10,272
국민은행연수중앙지점,38129,5508,3803,5505,3803,3,300
국민은행연수중앙지점,38571,1981,3361,1981,3361,0,172
국제금융단지,89292,8348,6464,8348,6464,0,477
국제금융단지,89293,2824,6675,2824,6675,0,306
국제성모병원,89030,390,1499,390,1499,0,60
국제성모병원,89031,2550,911,2550,911,0,111
국제성모병원(종점),89369,0,215,0,215,0,6
국제업무단지(공항청사),35026,14589,3674,14560,3674,29,589
국제업무지구역,38528,1863,3841,1863,3841,0,184
국제업무지구역5번출구,38619,2854,2351,2853,2351,1,167
국제이노베이션,37573,6,1735,3,1735,3,56
국제콘크리트,90050,33,27,32,27,1,1
국제콘크리트,90051,17,155,17,155,0,5
국제학교,38457,2757,1145,2757,1145,0,125
국제학교,38462,1455,2824,1455,2824,0,138
국촌,43251,81,0,77,0,4,2
국촌,43371,0,78,0,78,0,2
국화리야영장앞,43353,51,1,49,1,2,1
국화리야영장앞,43843,1,65,1,65,0,2
국화맨션,43359,0,4,0,4,0,0
국화맨션,43566,27,15,27,15,0,1
국회연수원입구,43920,0,22,0,22,0,0
군인아파트,43046,155,60,155,60,0,6
군인아파트,43047,29,146,29,146,0,5
굴다리,37142,7870,107,7870,107,0,257
굴다리오거리,40231,18696,8367,18617,8367,79,873
굴다리오거리,40232,15217,22266,15166,22266,51,1209
굴다리입구,37152,7834,3882,7806,3882,28,377
굴포천,40506,2595,2858,2595,2858,0,175
굴포천,40509,3120,3963,3120,3963,0,228
굴포천역(롯데마트),40814,42428,24447,42404,24447,24,2157
굴포천역(롯데마트),40815,18100,22885,18097,22885,3,1322
굴포천역(부평농협),40507,6377,8970,6370,8970,7,495
굴포천역(부평농협),40508,9699,5992,9677,5992,22,506
굴포천역(신복사거리),40485,4436,20449,4436,20449,0,802
굴포천역(신복사거리),40498,29308,7471,29285,7471,23,1186
굴포천역(욱일아파트),40519,4203,12711,4193,12711,10,545
굴포천역(욱일아파트),40522,8515,2855,8499,2855,16,366
궁골,43346,0,6,0,6,0,0
궁골,43572,6,1,5,1,1,0
궁현사거리,37575,4,880,4,880,0,28
궁현사거리,37576,238,1,233,1,5,7
귀뚜라미보일러,42003,1,145,1,145,0,4
귀뚜라미보일러,42004,199,1,199,1,0,6
귤현감리교회,41385,2055,5883,2049,5883,6,256
귤현감리교회,41386,3941,2839,3932,2839,9,218
귤현동마을입구,41326,354,104,351,104,3,14
귤현동마을입구,41328,80,503,80,503,0,18
귤현아이파크정문,41572,2243,416,2243,416,0,85
귤현역,41331,9052,3659,9047,3659,5,410
귤현역,41332,1351,808,1350,808,1,69
귤현차량기지(센트레빌3단지),41443,2309,683,2308,683,1,96
귤현차량기지(센트레빌3단지),41444,989,3204,986,3204,3,135
귤현차량기지(안골공원),41618,1946,2383,1946,2383,0,139
귤현차량기지(안골공원),41619,70,576,70,576,0,20
귤현차량사업소,41670,1,18,1,18,0,0
귤현현대아이파크,41620,636,2105,636,2105,0,88
그린나래지하차도,35648,13,488,13,488,0,16
그린나래지하차도,35649,2124,950,2124,950,0,99
그린빌라,42222,2100,1303,2054,1303,46,109
그린빌라,42602,1285,2912,1274,2912,11,135
그린힐아파트,40194,320,1747,313,1747,7,66
극동.금호아파트,39272,4712,6520,4678,6520,34,362
극동.금호아파트,39278,5473,5064,5451,5064,22,339
극지연구소,39918,2005,2697,2001,2697,4,151
극지연구소,39919,3769,2383,3769,2383,0,198
근대문화거리입구,35369,2317,4345,2298,4345,19,214
근대문화거리입구,35370,3073,2056,3058,2056,15,165
근로복지공단인천병원,40145,8483,12144,8468,12144,15,665
근로복지공단인천병원,40155,19108,8251,19089,8251,19,882
글로벌캠퍼스푸르지오,39841,2214,7901,2209,7901,5,326
글로벌파크,39975,711,586,711,586,0,41
글로벌파크,39976,119,1543,119,1543,0,53
글로벌파크베르디움,39840,6720,1528,6719,1528,1,266
금강다이아몬드,39007,433,1654,430,1654,3,67
금강다이아몬드,39008,849,423,849,423,0,41
금강마을,55066,1767,2470,1751,2470,16,136
금강마을,55068,4971,900,4940,900,31,189
금강요양병원,37291,8101,5331,8077,5331,24,433
금강종합상가,42858,1076,24,1073,24,3,35
금강찜질방,44113,37,18,28,18,9,1
금강찜질방,44149,17,19,17,19,0,1
금강찜질방,44150,8,27,8,27,0,1
금강찜질방,44151,5,0,4,0,1,0
금강탱크터미널,42758,1105,2043,1100,2043,5,101
금강펜테리움더시글로,89392,8646,4834,8640,4834,6,434
금강펜테리움더시글로,89459,2503,4076,2498,4076,5,212
금곡교차로,89370,8,31,8,31,0,1
금곡동,42471,23,172,23,172,0,6
금곡동,42587,437,90,432,90,5,17
금곡종점,89319,104,66,80,66,24,5
금란마트,89056,120,896,119,896,1,32
금란마트,89061,10,280,8,280,2,9
금마초등학교,40833,6000,3758,5856,3758,144,314
금산경로당,35564,5,592,5,592,0,19
금산경로당,35565,10,8,10,8,0,0
금성목재,42812,0,157,0,157,0,5
금운교,43298,0,47,0,47,0,1
금운교,43858,1,50,1,50,0,1
금월리종점,43777,169,66,166,66,3,7
금정골입구,90301,2,6,2,6,0,0
금정부락,90300,1,2,1,2,0,0
금호2차아파트,37031,7503,1225,7490,1225,13,281
금호2차아파트,37033,1866,4859,1848,4859,18,216
금호베스트빌1단지.영종도서관,35112,1308,1777,1307,1777,1,99
금호베스트빌1단지.영종도서관,35113,3553,1456,3552,1456,1,161
금호아파트,37061,268,521,268,521,0,25
금호아파트,38302,679,982,674,982,5,53
금호아파트,38349,10957,3251,10933,3251,24,458
금호아파트,40441,3251,1364,3251,1364,0,148
금호아파트,40795,21743,20012,21733,20012,10,1346
금호아파트,40845,8001,8642,7985,8642,16,536
금호어울림,35313,3363,1183,3363,1183,0,146
금호어울림,35384,1051,2910,1051,2910,0,127
금호어울림,37048,1147,2277,1114,2277,33,110
금호어울림2차,35597,4,1,4,1,0,0
금호어울림2차,35598,0,3,0,3,0,0
금호어울림아파트,42137,3821,2318,3815,2318,6,198
금호어울림아파트,42139,2407,2941,2401,2941,6,172
금호어울림아파트,42592,157,1397,157,1397,0,50
금호어울림아파트,42593,1428,697,1425,697,3,68
금호이수마운트밸리,40316,421,878,421,878,0,41
금호종합열처리,42801,694,82,694,82,0,25
금호타운,37024,14515,3431,14491,3431,24,578
금호타운,37026,4733,15625,4721,15625,12,656
금홍염전,35543,587,246,587,246,0,26
금홍염전,35544,418,3089,418,3089,0,113
기계공고,37294,4221,2685,4198,2685,23,222
기계철제단지,36129,9,191,7,191,2,6
기계철제단지,36149,169,66,169,66,0,7
기신정기,39567,876,1707,876,1707,0,83
기업은행(구월동지점),39178,216,443,216,443,0,21
기업은행앞,70152,141,26,140,26,1,5
기점(미정차)_517 519,37677,1112,0,1112,0,0,35
긴마루교회입구,35686,85,31,83,31,2,3
긴마루교회입구,35692,10,55,10,55,0,2
길병원,39250,81515,78658,81322,78658,193,5166
길병원,39262,14507,11324,14497,11324,10,833
길병원,39264,6378,9016,6359,9016,19,496
길병원,39590,75802,69424,75654,69424,148,4684
길병원사거리,39212,20706,19282,20633,19282,73,1289
길병원사거리,39216,19396,25041,19312,25041,84,1433
길상교회,43148,37,13,35,13,2,1
길상교회,43701,12,39,12,39,0,1
길상군립어린이집,43959,50,20,50,20,0,2
길상군립어린이집,43960,33,64,33,64,0,3
길상낚시터,43149,10,12,9,12,1,0
길상낚시터,43883,7,4,7,4,0,0
길상면주민복합센터,90409,104,197,104,197,0,9
길상면주민복합센터,90410,157,213,157,213,0,11
길상보건지소,43021,238,459,238,459,0,22
길상보건지소,43069,248,314,245,314,3,18
길정저수지,90054,1,1,1,1,0,0
길정저수지,90055,2,4,2,4,0,0
길직1리,43270,101,112,100,112,1,6
길직리,43031,173,154,173,154,0,10
길직리입구,43304,2,65,2,65,0,2
길직리입구,43313,66,3,65,3,1,2
길훈4차아파트,80040,11,411,11,411,0,13
길훈4차아파트,80041,363,2,363,2,0,11
길훈아파트,42494,9516,10348,9513,10348,3,640
김미현골프장,39749,1250,720,1250,720,0,63
김미현골프장,39751,681,2082,681,2082,0,89
김소골,35675,18,43,18,43,0,1
김소골,35703,40,31,39,31,1,2
김지곡,43455,4,56,2,56,2,1
김지곡,43831,60,1,58,1,2,1
김포공항국내선,25029,1587,2801,1582,2801,5,141
김포공항국내선,25091,513,94,509,94,4,19
김포공항국제선,25006,851,4735,851,4735,0,180
김포공항국제선,25164,80,178,79,178,1,8
김포대학입구,80257,548,47,546,47,2,19
김포대학입구,80258,63,493,62,493,1,17
김포초교,80028,143,505,143,505,0,20
김포초교,80030,511,117,511,117,0,20
김포한강신협,80032,1049,1393,1037,1393,12,78
김포한강신협,80035,1201,1164,1185,1164,16,76
까치공원.작전도서관,41149,15206,11869,15154,11869,52,873
까치말사거리,41563,9287,3519,9287,3519,0,413
까치말사거리,41564,3581,7320,3581,7320,0,351
꿈동산.사랑마을,55022,1490,2355,1484,2355,6,124
꿈동산.사랑마을,55024,1745,146,1742,146,3,61
꿈에그린아파트,92023,3622,4117,3621,4117,1,249
나누리병원,40398,28427,21122,28386,21122,41,1598
나누리병원,40784,25349,21159,25309,21159,40,1500
나래병원,38142,3209,2335,3209,2335,0,178
나룻개,35593,42,331,42,331,0,12
나룻개,35594,306,30,303,30,3,10
나룻개입구,35385,39,288,39,288,0,10
나룻개입구,35386,267,22,262,22,5,9
나무깨,90183,2,2,2,2,0,0
나무깨,90184,1,4,1,4,0,0
나무다리,90340,1,9,1,9,0,0
나무다리,90344,8,0,8,0,0,0
나사렛국제병원앞,38068,49139,15879,48955,15879,184,2097
나은병원,42056,7184,2503,7125,2503,59,312
낚시터매점,43356,5,63,5,63,0,2
낚시터매점,43840,43,0,42,0,1,1
낚시터입구,42802,89,759,89,759,0,27
난곳정미소,90286,22,62,22,62,0,2
난정1리마을회관,90285,25,23,24,23,1,1
난정1리마을회관,90287,6,2,6,2,0,0
난정교회앞,90288,2,1,2,1,0,0
난정보건진료소앞,90289,1,6,1,6,0,0
난정초등학교입구,90305,16,6,16,6,0,0
남광로얄아파트,37257,19979,28379,19933,28379,46,1559
남광하우스토리,42841,3523,843,3520,843,3,140
남광하우스토리,42920,4616,1579,4615,1579,1,199
남광하우스토리,42921,2175,4342,2171,4342,4,210
남동I.C(문학동입구),39168,120,4466,114,4466,6,147
남동경기장,92055,254,57,254,57,0,10
남동경찰서·남촌농산물도매시장,39147,3396,1912,3393,1912,3,171
남동경찰서·남촌농산물도매시장,39148,2217,1636,2215,1636,2,124
남동고등학교,92035,172,313,172,313,0,15
남동고등학교,92036,29,100,29,100,0,4
남동공단2호공원,39075,784,5319,783,5319,1,196
남동공단근린공원앞,39073,5120,1026,5119,1026,1,198
남동공단우체국,39076,2074,6226,2074,6226,0,267
남동구청,39263,10392,8299,10392,8299,0,602
남동구청,39279,10838,10115,10834,10115,4,675
남동구청역,39318,12178,7822,12148,7822,30,645
남동구청역,39324,12260,14489,12237,14489,23,862
남동구청후문(남동등기소),39287,5546,11284,5501,11284,45,542
남동구청후문(남동등기소),39288,4805,3059,4788,3059,17,253
남동국가산업단지 입구,39853,529,7,516,7,13,17
남동국가산업단지(기신정기),39568,1545,1282,1545,1282,0,91
남동대교,38090,2693,7836,2693,7836,0,339
남동대교(스퀘어원),39063,6109,3650,5965,3650,144,314
남동빌라,39330,4909,1590,4900,1590,9,209
남동세무서,39887,21243,11535,21235,11535,8,1057
남동세무서,39888,12852,23217,12848,23217,4,1163
남동소래아트홀,39743,572,110,572,110,0,22
남동소래아트홀,39744,259,77,259,77,0,10
남동소래아트홀,39748,117,233,117,233,0,11
남동소래아트홀,39792,78,461,78,461,0,17
남동소방서,39252,1105,2601,1091,2601,14,119
남동소방서,39587,10826,6644,10724,6644,102,563
남동시범공단앞,39100,3327,5125,3327,5125,0,272
남동시범공단앞,39102,6155,2661,6155,2661,0,284
남동아시아드럭비경기장,39214,348,712,345,712,3,34
남동아시아드럭비경기장,39215,303,636,298,636,5,30
남동인더스파크역,39074,13077,2510,13073,2510,4,502
남동인더스파크역1번출구,92045,110,0,110,0,0,3
남동인더스파크역1번출구,92050,1,88,1,88,0,2
남동정수장,39372,185,726,185,726,0,29
남동중학교,39220,11138,6197,11107,6197,31,559
남동중학교,39224,5628,5291,5618,5291,10,352
남동체육관,39930,1045,877,1045,877,0,62
남동체육관,39947,665,1508,665,1508,0,70
남동체육관(체조경기장),39682,1786,2460,1782,2460,4,136
남동체육관(체조경기장),39862,959,707,959,707,0,53
남동초등학교,39254,16810,26117,16809,26117,1,1384
남동초등학교,39255,30549,13912,30541,13912,8,1434
남동초등학교,39265,4983,584,4937,584,46,179
남동화원,39300,6120,6508,6119,6508,1,407
남디4거리,35271,317,840,317,840,0,37
남디4거리,35280,420,432,420,432,0,27
남부고가교,40921,5,257,5,257,0,8
남산리,43324,2,0,2,0,0,0
남산리,43628,20,20,20,20,0,1
남산유스호스텔,43982,16,0,16,0,0,0
남산유스호스텔,43985,19,28,6,28,13,1
남산포입구,90030,4,44,4,44,0,1
남산포입구,90031,52,0,45,0,7,1
남성네고개,35426,40,188,40,188,0,7
남성네고개,35427,192,12,192,12,0,6
남씨농원앞,41495,10,54,10,54,0,2
남씨농원앞,41511,12,1,12,1,0,0
남양목재,42814,0,261,0,261,0,8
남인천농협백운지점,37174,215,990,215,990,0,38
남인천여자중학교,39190,17848,6288,17746,6288,102,778
남인천여자중학교,39191,7954,17534,7932,17534,22,822
남중학교,37331,5554,588,5554,588,0,198
남중학교,37336,7677,19521,7677,19521,0,877
남청라TG,89379,178,1,178,1,0,5
남청라TG,89380,4,244,3,244,1,8
남촌농산물도매시장,92031,4686,80,4668,80,18,153
남촌농산물도매시장,92032,12,2955,12,2955,0,95
남촌농산물도매시장채소동앞,92033,74,1424,74,1424,0,48
남촌농산물도매시장채소동앞,92034,284,481,282,481,2,24
남촌동다목적센터,39908,61,1224,61,1224,0,41
남촌동다목적체육센터,39907,155,210,155,210,0,11
남촌동입구,39166,3574,9049,3570,9049,4,407
남촌입구,39156,188,616,186,616,2,25
남촌입구,39157,580,1443,579,1443,1,65
남촌풍림2차아파트,39171,5577,10478,5574,10478,3,517
남촌풍림3차아파트,39165,4146,4028,4139,4028,7,263
남촌풍림3차아파트,39167,4076,4761,4072,4761,4,285
남촌풍림아파트,39172,11360,3309,11358,3309,2,473
남항유어선부두,35078,5736,1320,5687,1320,49,227
남항유어선부두,35079,127,5168,111,5168,16,170
납섬입구,90185,16,5,16,5,0,0
납섬입구,90186,8,5,8,5,0,0
내2리마을회관앞,44138,29,30,29,30,0,1
내2리마을회관앞,44152,30,25,30,25,0,1
내3리다목적회관앞,44121,0,5,0,5,0,0
내3리다목적회관앞,44153,2,0,2,0,0,0
내3리마을회관,44154,5,0,5,0,0,0
내3리마을회관,44155,1,9,1,9,0,0
내3리마을회관,44156,8,6,8,6,0,0
내4리마을회관,44104,14,48,13,48,1,2
내4리마을회관,44157,21,8,20,8,1,0
내5리마을회관,44128,5,2,5,2,0,0
내5리마을회관,44158,1,2,1,2,0,0
내7리마을회관,44118,4,3,2,3,2,0
내7리마을회관,44159,9,7,7,7,2,0
내가면사무소(맞은편),43906,47,25,47,25,0,2
내가면사무소(사무소),43907,17,105,16,105,1,3
내가시장,43392,161,232,155,232,6,12
내가시장,43484,357,131,339,131,18,15
내가초등학교,43368,89,14,84,14,5,3
내가초등학교,43554,14,108,13,108,1,3
내건너,90167,41,41,41,41,0,2
내건너,90168,21,9,21,9,0,0
내동교회,44114,14,23,11,23,3,1
내동교회,44206,1,8,1,8,0,0
내동삼거리,44111,5,7,5,7,0,0
내리고개넘어,44102,3,0,3,0,0,0
내리교회,43395,18,9,18,9,0,0
내리교회,43543,25,47,24,47,1,2
내리쉼터,43968,1,7,1,7,0,0
내리쉼터,43972,14,1,14,1,0,0
내리어촌계사무실,44135,0,14,0,14,0,0
내리어촌계사무실,44204,1,0,1,0,0,0
내리주유소.한국화장품삼거리,57016,1367,1627,1367,1627,0,96
내리주유소.한국화장품삼거리,57018,2088,2069,2086,2069,2,134
내촌,43343,66,60,64,60,2,4
내촌,43581,60,21,60,21,0,2
내촌입구,90394,1,96,1,96,0,3
내촌입구,90395,11,19,11,19,0,0
너출(드무리입구),44086,0,1,0,1,0,0
너출(드무리입구),44161,3,0,3,0,0,0
넘말,43140,2,0,2,0,0,0
넘말,43438,0,9,0,9,0,0
넙디,35574,1944,8086,1944,8086,0,323
넙디,35575,10544,1553,10544,1553,0,390
넙디마을입구,35389,122,98,122,98,0,7
노가리해변,44105,0,1,0,1,0,0
노가리해변,44162,1,0,1,0,0,0
노랑새고개,43273,99,23,94,23,5,3
노랑새고개,43570,27,84,26,84,1,3
노인복지관,92072,543,919,535,919,8,47
노인복지관,92073,211,3203,211,3203,0,110
노인복지회관,37599,151,759,151,759,0,29
녹청자박물관,42668,2637,387,2637,387,0,97
녹청자박물관,42669,196,1871,196,1871,0,66
논고개길,39687,2176,2346,2158,2346,18,145
논고개길,39819,2052,2057,2049,2057,3,132
논고개길사거리,39870,298,5,292,5,6,9
논골,35318,26,11,26,11,0,1
논골,35394,24,16,24,16,0,1
논골,44098,0,4,0,4,0,0
논골,44163,2,13,2,13,0,0
논골경로당 입구,35770,4,4,3,4,1,0
논골경로당 입구,35771,0,16,0,16,0,0
논현10단지별빛마을웰카운티A정문,39121,5795,2737,5794,2737,1,275
논현10단지별빛마을웰카운티A후문,39599,983,1637,983,1637,0,84
논현11단지단풍마을,39616,436,201,436,201,0,20
논현11단지단풍마을A정문,39582,3750,5504,3748,5504,2,298
논현12단지산뒤마을,39609,5432,12404,5422,12404,10,575
논현13단지푸르네마을,39611,4036,7057,4029,7057,7,357
논현13단지푸르네마을,39617,4397,2284,4397,2284,0,215
논현13단지푸르네마을,39618,1858,2546,1858,2546,0,142
논현14단지등대마을,39610,10075,1531,10028,1531,47,374
논현14단지등대마을휴먼시아아파트,39612,9412,4176,9375,4176,37,438
논현1동행정복지센터,39598,1621,868,1620,868,1,80
논현2단지범마을,39625,2784,10543,2782,10543,2,429
논현2동행정복지센터,39571,1356,205,1356,205,0,50
논현2동행정복지센터,39572,195,1005,195,1005,0,38
논현2동행정복지센터,39636,1329,3096,1329,3096,0,142
논현2동행정복지센터,39697,2817,1358,2817,1358,0,134
논현3단지하늘마을301동,39631,108,3190,108,3190,0,106
논현3단지하늘마을302동,39624,16962,5531,16940,5531,22,725
논현3단지하늘마을305동,39626,2165,4775,2165,4775,0,223
논현3단지하늘마을305동,39627,3887,2393,3887,2393,0,202
논현5단지달맞이마을,39079,9641,3569,9629,3569,12,426
논현6단지어진마을한화꿈에그린A정문,39078,4359,7080,4348,7080,11,369
논현8단지동산마을,39104,5000,2026,5000,2026,0,226
논현8단지동산마을,39569,417,831,417,831,0,40
논현8단지동산마을,39570,433,497,433,497,0,30
논현9단지냇마을신영지웰A,39101,2329,4069,2329,4069,0,206
논현9단지냇마을신영지웰A,39602,430,177,430,177,0,19
논현9단지냇마을신영지웰A,39603,30,670,28,670,2,22
논현9단지냇마을신영지웰A정문,39600,2409,1089,2397,1089,12,112
논현고잔동행정복지센터,39707,8470,13374,8463,13374,7,704
논현동힐스테이트,39708,20423,10560,20394,10560,29,999
논현사거리,39504,5106,4355,5088,4355,18,305
논현사거리,39505,4350,4390,4346,4390,4,281
논현센트럴뷰·에코메트로5단지,39693,732,1042,732,1042,0,57
논현신일해피트리아파트,39088,2429,7676,2426,7676,3,325
논현신일해피트리아파트,39089,7334,2851,7329,2851,5,328
논현역,32007,130,2979,130,2979,0,100
논현역,32008,3955,62,3955,62,0,129
논현유승한내들,39839,1540,2929,1540,2929,0,144
논현유승한내들,39923,3344,1141,3343,1141,1,144
논현주공1단지,39112,13928,6945,13926,6945,2,673
논현주공2단지,39106,12057,12419,12052,12419,5,789
논현주공아파트(인천금융고),39096,12889,10829,12885,10829,4,765
논현주공아파트(인천금융고),39098,15499,13320,15493,13320,6,929
논현중앙공원·남동논현도서관,39604,403,2032,400,2032,3,78
논현중학교,39573,1110,145,1110,145,0,40
논현중학교,39574,50,597,50,597,0,20
논현초등학교,39601,707,2151,705,2151,2,92
논현포대근린공원,92056,69,49,69,49,0,3
논현푸르지오.유호엔시티,39822,2135,113,2128,113,7,72
논현화훼단지,39830,139,1209,139,1209,0,43
논현화훼단지,39831,203,685,203,685,0,28
농기계은행앞,90036,0,23,0,23,0,0
농기계은행앞,90037,20,0,20,0,0,0
농도원,43178,45,99,45,99,0,4
농도원,43355,137,22,133,22,4,5
농막골,90189,5,1,5,1,0,0
농막골,90190,11,5,0,5,11,0
농산물시장,40688,3094,967,3092,967,2,131
농어바위캠핑장,44140,6,1,4,1,2,0
농어바위캠핑장,44164,21,18,21,18,0,1
농어촌공사앞,43268,119,15,118,15,1,4
농어촌공사앞,43489,20,103,18,103,2,3
농업기술센터,43357,180,121,166,121,14,9
농업기술센터,43573,53,200,50,200,3,8
농장주유소,39472,305,1041,305,1041,0,43
농장주유소,39508,226,718,226,718,0,30
농협로타리,40244,1413,2815,1413,2815,0,136
농협로타리,40248,1977,1472,1977,1472,0,111
농협로타리,40251,1493,2435,1493,2435,0,126
농협로타리,40751,4593,2938,4578,2938,15,242
농협하나로마트,44117,1,0,1,0,0,0
농협하나로마트,44165,0,6,0,6,0,0
높은마을입구,35685,27,48,27,48,0,2
높은마을입구,35693,51,67,51,67,0,3
누촌,43238,64,177,62,177,2,7
누촌,43360,162,44,157,44,5,6
뉴그린아트빌,40875,1258,786,1258,786,0,65
뉴그린아트빌,40876,193,1417,192,1417,1,51
뉴서울1차아파트,40275,13739,7228,13517,7228,222,676
뉴서울3차아파트,41026,1953,4163,1953,4163,0,197
뉴서울3차아파트,41029,8850,1367,8829,1367,21,329
뉴서울3차아파트,41032,1397,5367,1365,5367,32,218
뉴서울6차아파트,41632,1728,391,1721,391,7,68
뉴서울6차아파트,41635,415,1794,415,1794,0,71
뉴서울아파트,38303,1681,1458,1676,1458,5,101
뉴서울아파트,39234,8371,149,8333,149,38,274
뉴서울아파트,39235,196,4513,193,4513,3,151
뉴서울아파트,40505,2215,1025,2169,1025,46,104
뉴서울아파트,40514,574,623,570,623,4,38
뉴서울아파트,40526,1987,4092,1984,4092,3,196
뉴서울아파트,41153,7080,7119,7080,7119,0,458
뉴서울아파트,89071,9107,22165,9069,22165,38,1008
느티나무,43182,19,71,19,71,0,2
느티나무,43232,79,18,76,18,3,3
늘목,35414,165,402,165,402,0,18
늘목,35415,417,96,416,96,1,16
늘목마을입구,35529,15,51,15,51,0,2
늘목마을입구,35725,33,7,33,7,0,1
늘목마을입구삼거리,35889,1,16,1,16,0,0
늘푸른벽산.서강2차,70021,16,2366,16,2366,0,76
능곡마을회관,43553,58,13,55,13,3,2
능곡마을회관,43649,7,44,7,44,0,1
능미,43921,67,7,67,7,0,2
능미,43922,9,59,9,59,0,2
능안,43276,72,89,70,89,2,5
능안,43571,50,59,50,59,0,3
능촌삼거리,90370,0,12,0,12,0,0
능촌입구,43560,13,0,13,0,0,0
능촌입구,43854,0,21,0,21,0,0
능허대공원,38567,635,907,635,907,0,49
능허대공원,38777,138,196,101,196,37,10
다남동소촌마을입구,41329,788,21,782,21,6,26
다남동소촌마을입구,41330,12,937,12,937,0,30
다남동역골입구,41333,2,267,2,267,0,8
다남동역골입구,41334,177,10,175,10,2,6
다남성결교회,41664,64,83,64,83,0,4
다남성결교회,41665,2,164,2,164,0,5
다남식당,41477,1848,16578,1841,16578,7,594
다남식당,41478,715,3285,712,3285,3,129
다리목,43717,8,9,7,9,1,0
다리목,43845,8,13,7,13,1,0
다사랑마을입구,35887,50,8,50,8,0,1
다사랑마을입구,35888,15,42,15,42,0,1
다우리농장,44083,9,0,3,0,6,0
다우리농장,44166,0,1,0,1,0,0
다운,43605,68,76,64,76,4,4
다운,43822,97,50,97,50,0,4
다운1리,43582,20,92,19,92,1,3
다운1리,43821,44,11,40,11,4,1
다운마을,43398,6,80,6,80,0,2
다운마을,43824,77,0,76,0,1,2
다임메가타운,40870,31,550,31,550,0,18
단봉초등학교,42380,4019,722,4012,722,7,152
단봉초등학교,42382,852,3546,846,3546,6,141
달빛축제공원,38620,98,100,98,100,0,6
달빛축제공원,38621,124,867,124,867,0,31
달빛축제공원대공연장,38733,220,741,220,741,0,31
달빛축제공원대공연장,38734,1120,411,1120,411,0,49
담방로사거리,39275,12643,4301,12588,4301,55,546
담방아파트,39226,598,89,595,89,3,22
당곡고개,80048,122,805,122,805,0,29
당곡고개,80049,765,75,765,75,0,27
당미마을,41552,4040,5857,4039,5857,1,319
당미마을,41553,4104,3427,4090,3427,14,242
당산리,43450,2,140,2,140,0,4
당산리,43700,139,3,139,3,0,4
당산리검문소,43699,127,6,122,6,5,4
당산리검문소,43752,4,127,3,127,1,4
당산종점,43669,2,21,2,21,0,0
당산종점,43725,33,2,33,2,0,1
당산초등학교,41418,5041,2944,5021,2944,20,257
당산초등학교,41419,1826,2338,1818,2338,8,134
당산초등학교아래사거리,41644,33,122,33,122,0,5
당산초등학교아래사거리,41645,430,206,430,206,0,20
당하금호어울림1차,42435,120,210,120,210,0,10
당하농원,42390,1,9,1,9,0,0
당하대주파크빌,42392,2435,2049,2428,2049,7,144
당하동탑스빌아파트,42639,4589,3379,4585,3379,4,257
당하동행정복지센터,42886,11202,5875,11158,5875,44,550
당하마트,42618,8,43,8,43,0,1
당하마트,42619,5,66,5,66,0,2
당하메디칼,42402,1704,2173,1694,2173,10,125
당하초등학교,42396,1624,930,1620,930,4,82
당하초등학교,42399,1178,1375,1175,1375,3,82
당하탑스빌아파트,42393,2569,2599,2567,2599,2,166
당하푸르지오,42403,1225,819,1219,819,6,65
당하푸르지오,42502,713,4014,712,4014,1,152
당하풍림아파트,42405,1583,11271,1583,11271,0,414
대경화성,39789,1265,860,1265,860,0,68
대경화성,39790,1239,1755,1239,1755,0,96
대곶사거리,80008,1419,6153,1414,6153,5,244
대곶사거리,80009,7494,1502,7476,1502,18,290
대기이에스티,39013,138,351,138,351,0,15
대덕강업앞,42759,26,540,26,540,0,18
대동1차후문(종점),40553,385,681,385,681,0,34
대동도어(주),39983,427,22,427,22,0,14
대동도어(주),39984,8,727,8,727,0,23
대동아파트,37042,7454,2249,7446,2249,8,313
대동아파트,37504,4247,6861,4240,6861,7,358
대동아파트,38128,6589,11466,6568,11466,21,582
대동아파트,38345,5380,5776,5345,5776,35,359
대동아파트,39256,334,4991,327,4991,7,171
대동아파트,39473,3646,203,3611,203,35,124
대동아파트,39474,91,6766,81,6766,10,221
대동아파트,40491,634,252,629,252,5,28
대동아파트,40569,8017,3255,8010,3255,7,363
대동아파트,41172,2447,633,2445,633,2,99
대동아파트,41173,21,1390,18,1390,3,45
대동아파트,42304,2413,3996,2397,3996,16,206
대동아파트,42306,2927,1819,2922,1819,5,153
대동아파트정문앞,40277,1348,1018,1342,1018,6,76
대동아파트후문,41137,2257,4090,2249,4090,8,204
대동월드,38116,5187,2902,5184,2902,3,260
대동특수철강,39049,116,1150,116,1150,0,40
대룡2리마을회관앞,90026,2,44,0,44,2,1
대룡2리마을회관앞,90027,73,2,72,2,1,2
대룡시장,90020,327,1146,323,1146,4,47
대룡시장,90021,1176,309,1143,309,33,47
대륭맨숀,40242,9547,5933,9508,5933,39,499
대륭맨숀,40247,10208,10498,10178,10498,30,667
대림3차아파트301동앞,38681,303,24,303,24,0,10
대림3차아파트301동앞,38684,37,791,37,791,0,26
대림아파트,37053,11936,4436,11929,4436,7,528
대림아파트,37054,3192,8067,3191,8067,1,363
대림아파트,38257,5705,1389,5705,1389,0,228
대림아파트,40382,3756,11677,3720,11677,36,497
대림아파트,42609,1771,1469,1757,1469,14,104
대림아파트,42610,145,2074,145,2074,0,71
대림아파트후문,40397,2081,1565,2053,1565,28,117
대명아파트,37537,2328,6362,2328,6362,0,280
대명초교,80002,1833,105,1825,105,8,62
대명초교,80003,248,1628,247,1628,1,60
대문리고개입구,43546,495,373,484,373,11,28
대문목재,89206,97,42,97,42,0,4
대문목재,89207,189,14,189,14,0,6
대문촌마을,90058,28,6,28,6,0,1
대문촌마을,90059,0,5,0,5,0,0
대박주유소,36091,2356,2561,2354,2561,2,158
대부고교차로,18388,2,4,2,4,0,0
대부관광호텔,62040,212,48,212,48,0,8
대부도서관,18389,3,36,3,36,0,1
대부도서관,18391,13,16,13,16,0,0
대부동행정복지센터,62011,306,1268,273,1268,33,50
대부동행정복지센터,62012,1160,221,1147,221,13,44
대부중고등학교,62027,261,38,256,38,5,9
대부중고등학교,62028,49,275,49,275,0,10
대부파출소앞,62036,7,113,7,113,0,3
대부파출소앞,62042,75,6,75,6,0,2
대사마을,43947,10,228,10,228,0,7
대사마을,43948,206,9,201,9,5,6
대산-기점,90259,2279,2186,2230,2186,49,144
대상스틸,89007,61,536,60,536,1,19
대성베르힐아파트(가정성당),89240,1526,3031,1521,3031,5,147
대성베르힐아파트(가정성당),89241,5683,2107,5670,2107,13,251
대성유니드아파트,40674,978,4257,978,4257,0,168
대성유니드아파트,40675,2306,424,2306,424,0,88
대신아파트,41406,6118,1888,6111,1888,7,258
대신철강,42859,13,1136,13,1136,0,37
대야초교.ABC학습타운입구,70017,371,1575,359,1575,12,62
대야초교.ABC학습타운입구,70020,1735,513,1725,513,10,72
대양자동차학원,35073,11,2158,10,2158,1,69
대우삼환아파트,38078,6126,4217,6117,4217,9,333
대우삼환아파트,38591,1393,3352,1390,3352,3,153
대우실업,41485,8,28,8,28,0,1
대우실업,41505,21,1,21,1,0,0
대우아파트,38206,4568,4009,4553,4009,15,276
대우아파트,38208,3875,3150,3863,3150,12,226
대우아파트,40321,192,411,192,411,0,19
대우아파트,40340,959,581,934,581,25,49
대우일렉트로닉스,37462,91,1805,91,1805,0,61
대우일렉트로닉스,37463,1040,658,1037,658,3,54
대우자동차운전학원,42262,401,300,401,300,0,22
대우자동차운전학원,42263,170,522,170,522,0,22
대우재아파트,39702,7,400,5,400,2,13
대우재아파트,39703,438,393,437,393,1,26
대우푸르지오,42407,27370,3666,27331,3666,39,1001
대우푸르지오,42842,1039,3540,1035,3540,4,147
대우푸르지오복합상가,39605,2846,1797,2812,1797,34,149
대우하나아파트,89073,17206,10820,17176,10820,30,904
대우하나아파트,89074,9105,11166,9085,11166,20,653
대웅실업앞,92003,57,339,57,339,0,12
대원정밀,39475,419,829,419,829,0,40
대월초등학교,90094,0,4,0,4,0,0
대월초등학교,90095,9,0,9,0,0,0
대은교회,42143,5182,8744,5153,8744,29,449
대인고등학교,42344,2418,2539,2413,2539,5,159
대인고등학교,42345,3423,1793,3406,1793,17,168
대인고등학교,89490,164,821,164,821,0,31
대일엠앤쿡,39059,884,1782,884,1782,0,86
대장간마을,43703,240,114,227,114,13,11
대정,90117,5,53,4,53,1,1
대정,90118,52,4,51,4,1,1
대주아파트,42469,2006,10887,2006,10887,0,415
대주파크빌,42466,5830,1458,5830,1458,0,235
대진아파트,40415,2738,2519,2721,2519,17,169
대촌,43393,61,68,60,68,1,4
대촌,43545,38,27,37,27,1,2
대촌마을,41663,7,2,7,2,0,0
대토단지앞,39813,982,8,982,8,0,31
대한솔루션알앤디센터,39557,31,313,31,313,0,11
대한제당,35169,1178,39,1176,39,2,39
대한제당,35220,4,1437,4,1437,0,46
대현목재,89205,146,31,146,31,0,5
대화초등학교,37397,6315,2295,6314,2295,1,277
대화초등학교,37399,2557,4724,2557,4724,0,234
대흥,43194,22,276,22,276,0,9
대흥,43591,312,21,302,21,10,10
대흥식당,35688,60,15,59,15,1,2
대흥식당,35689,31,59,31,59,0,2
더리미경로당,43363,20,6,18,6,2,0
더리미경로당,43731,19,31,19,31,0,1
더리미미술관,43961,59,11,50,11,9,2
더리미미술관,43962,3,12,3,12,0,0
더리미장어마을,43680,2,37,2,37,0,1
더리미장어마을,43864,6,4,6,4,0,0
더샵그린스퀘어105동,92021,1659,161,1659,161,0,58
더샵그린스퀘어107동,92022,152,2396,152,2396,0,82
더샵그린애비뉴,38486,8279,8299,8279,8299,0,534
더샵그린애비뉴,38510,803,18,803,18,0,26
더샵그린워크1단지,38495,5622,2563,5595,2563,27,264
더샵부평센트럴시티(101동),40061,1894,2690,1885,2690,9,147
더샵부평센트럴시티(101동),40065,2704,1262,2683,1262,21,127
더샵부평센트럴시티(127동),40050,9890,15388,9848,15388,42,815
더샵센트럴시티204동,92020,39,1776,38,1776,1,58
더샵센트럴시티205동,92019,4702,2811,4698,2811,4,242
더샵송도마리나베이,38765,13,1174,13,1174,0,38
더샵송도마리나베이,38766,834,9,834,9,0,27
더샵송도프라임뷰20단지,38561,1399,4371,1376,4371,23,186
더샵엑스포빌리지,38480,7602,3128,7601,3128,1,346
더샵퍼스트파크13단지,38601,1202,212,1174,212,28,45
더샵퍼스트파크13단지,38602,119,695,119,695,0,26
더샵하버뷰,38485,11295,6906,11295,6906,0,587
더샵하버뷰,38487,3108,1809,3097,1809,11,158
더샵하버뷰(D13),38453,1357,832,1354,832,3,70
더샵하버뷰(D13),38466,1053,1742,1053,1742,0,90
더샵하버뷰(D14),38454,942,584,938,584,4,49
더샵하버뷰14단지,38504,1256,1420,1256,1420,0,86
더월드스테이트2단지,37657,952,510,932,510,20,47
더월드스테이트후문,37422,65,778,64,778,1,27
더포레스트아파트,39876,8684,1729,8680,1729,4,335
더포레스트아파트,39877,4980,8277,4979,8277,1,427
더프라우,38410,9499,23400,9499,23400,0,1061
더필립요양병원,40461,1853,4216,1853,4216,0,195
덕고개삼거리,43723,87,56,86,56,1,4
덕고개삼거리,43750,7,53,7,53,0,1
덕골,43397,25,0,25,0,0,0
덕골,43399,10,20,10,20,0,0
덕교3거리,35012,137,41,135,41,2,5
덕교동,35003,782,135,778,135,4,29
덕교동,35005,138,1351,138,1351,0,48
덕교동,35259,1326,298,1326,298,0,52
덕교삼거리,35214,38,180,38,180,0,7
덕신고등학교(강화읍교회),90228,29,141,24,141,5,5
덕신고등학교(강화읍교회),90229,136,121,135,121,1,8
덕유마을.설악마을,11187,2881,1458,2881,1458,0,139
덕유마을.설악마을,55073,1445,652,1445,652,0,67
덕음,43657,12,5,12,5,0,0
덕응,43983,14,25,14,25,0,1
덕응,43986,13,10,11,10,2,0
덕정가든,43173,0,22,0,22,0,0
덕정가든,43296,30,0,30,0,0,0
덕진사거리,43870,48,23,47,23,1,2
덕진사거리,90310,21,10,21,10,0,1
덕진진,43637,10,57,10,57,0,2
덕진진,43672,53,2,53,2,0,1
덕창기계,39723,184,56,184,56,0,7
덕포리,43006,346,196,342,196,4,17
덕포리,43100,153,289,141,289,12,14
덕하교앞,43449,7,19,7,19,0,0
덕하교앞,43727,7,33,7,33,0,1
덕화2리,43468,39,14,36,14,3,1
덕화2리,43730,8,19,7,19,1,0
덕화2리마을회관,43923,26,7,26,7,0,1
덕화2리마을회관,43924,7,18,7,18,0,0
덕화3리마을회관,43609,130,92,130,92,0,7
덕화3리입구,43469,3,6,3,6,0,0
덕화3리입구,43729,41,37,41,37,0,2
덕화교회앞,90398,0,28,0,28,0,0
덕화교회앞,90399,11,3,11,3,0,0
도간마을,43612,38,0,38,0,0,1
도간마을,43664,0,28,0,28,0,0
도감말,43733,12,4,12,4,0,0
도감말,43754,10,5,9,5,1,0
도곡한신아파트,23504,56,42,56,42,0,3
도담공원.푸르지오더베뉴,89397,4740,1640,4740,1640,0,205
도담공원.푸르지오더베뉴,89398,2827,4178,2827,4178,0,225
도담공원·인천이음중학교(서측),89482,1674,1753,1674,1753,0,110
도두리마을,41565,15856,1829,15856,1829,0,570
도두리마을,41566,2425,12023,2425,12023,0,466
도림고등학교,92066,182,231,182,231,0,13
도림동고개,39160,1091,616,1088,616,3,55
도림동고개,39161,619,1441,616,1441,3,66
도림동입구,39140,7655,1808,7648,1808,7,305
도림동입구,39141,20,1977,18,1977,2,64
도림아이파크아파트,39155,7299,3774,7279,3774,20,357
도림육교,39154,3175,6231,3165,6231,10,303
도림주공1단지,39152,15022,12054,14985,12054,37,873
도림주공1단지,39153,13969,11035,13944,11035,25,806
도림주공208동,39142,6913,3121,6896,3121,17,323
도림주공208동,39143,4616,7131,4611,7131,5,378
도림주공2단지,39146,4483,3962,4467,3962,16,272
도림주공2단지,39149,3439,2426,3436,2426,3,189
도림주철관1공장,89307,330,658,330,658,0,31
도림주철관공업(주),42293,3642,1129,3634,1129,8,153
도림포도원,39150,288,3507,283,3507,5,122
도림포도원,39151,381,365,381,365,0,24
도원고개(도원역),36001,4070,2617,4042,2617,28,215
도원고개(동구청방향),36170,19,31,19,31,0,1
도원동행정복지센터,35180,2601,2731,2592,2731,9,172
도원동행정복지센터,36128,62,256,62,256,0,10
도원동행정복지센터(앞),35788,148,168,148,168,0,10
도원동행정복지센터(앞),35798,216,113,216,113,0,10
도원역(인천축구전용경기장),35176,7200,4651,7126,4651,74,382
도원역(인천축구전용경기장),37549,1459,3312,1443,3312,16,153
도장골삼거리,44122,3,4,3,4,0,0
도장재마을,43167,14,2,13,2,1,0
도장재마을,43225,1,26,1,26,0,0
도화1동행정복지센터,37340,11468,10053,11413,10053,55,694
도화IC,37356,24752,19918,24717,19918,35,1440
도화e편한세상604동,37578,540,70,532,70,8,19
도화e편한세상아파트,37612,243,1615,243,1615,0,59
도화e편한세상아파트,37613,4324,1874,4319,1874,5,199
도화e편한세상아파트5단지,37624,3243,1012,3243,1012,0,137
도화e편한세상아파트6단지,37626,2061,3691,2060,3691,1,185
도화동신협(구박문여고),36003,10667,4458,10662,4458,5,487
도화동신협(구박문여고),37499,5216,8011,5204,8011,12,426
도화사거리.도화역,37390,912,669,912,669,0,51
도화사거리.도화역,37392,325,1131,325,1131,0,46
도화사거리·더샵인천스카이타워,37673,6589,3516,6581,3516,8,325
도화사거리·더샵인천스카이타워,37674,2274,6436,2266,6436,8,280
도화서희스타힐스,37625,1095,2389,1095,2389,0,112
도화역,37629,6457,7061,6457,7061,0,436
도화초등학교.수봉도서관,37366,7200,6399,7181,6399,19,438
도화초등학교.수봉도서관,37367,12152,12077,12100,12077,52,781
독골사거리,42175,3074,1322,3074,1322,0,141
독배로317번길(삼거리),37634,8653,1330,8653,1330,0,322
독장골,43351,7,19,7,19,0,0
독장골,43846,7,1,6,1,1,0
독정역(서구동구예비군훈련장),42377,4645,4060,4629,4060,16,280
독정역(서구동구예비군훈련장),42378,9107,6256,9098,6256,9,495
독정이고개,37234,29110,20469,28993,20469,117,1599
독정이고개,37238,19588,26796,19498,26796,90,1496
돈대마을,43925,22,5,20,5,2,0
돈대마을,43926,11,18,11,18,0,0
돈대모루,43422,13,11,13,11,0,0
돈대모루,43447,6,6,5,6,1,0
돌고래펜션,44127,1,0,1,0,0,0
돌고래펜션,44168,0,1,0,1,0,0
돌머루(대산종점),43707,90,53,87,53,3,4
돌산밑,35320,114,31,114,31,0,4
돌산밑,35396,18,165,16,165,2,5
돌성,43364,45,241,42,241,3,9
돌성,43587,264,68,261,68,3,10
돌팍재삼거리,35273,632,752,631,752,1,44
돌팍재삼거리,35277,880,649,875,649,5,49
돌팍재한뿌리,35304,206,249,206,249,0,14
돌팍재한뿌리,35315,151,287,151,287,0,14
동강리,35245,97,67,97,67,0,5
동강리,35246,57,75,52,75,5,4
동강리,35317,16,59,15,59,1,2
동강리,35393,113,38,112,38,1,4
동검도삼거리,43223,0,26,0,26,0,0
동검도삼거리,43642,57,0,52,0,5,1
동검리마을회관입구,90069,0,9,0,9,0,0
동검리마을회관입구,90070,11,0,11,0,0,0
동검리입구,43856,5,26,5,26,0,1
동검리입구,43877,35,11,35,11,0,1
동검리종점,43889,39,22,39,22,0,1
동검상회,43226,2,0,1,0,1,0
동광리어,41083,1146,470,1146,470,0,52
동광리어,41084,642,2086,642,2086,0,88
동광제일교회,40411,446,476,446,476,0,29
동교동삼거리,22012,6322,63,6322,63,0,205
동교동삼거리,23033,183,4579,183,4579,0,153
동구선거관리위원회,36110,3349,9255,3322,9255,27,406
동구청,36011,656,626,656,626,0,41
동구청소년수련관.달동네박물관,36026,16431,13782,16292,13782,139,974
동국제강,36068,1933,3554,1913,3554,20,177
동국제강,36074,356,213,340,213,16,18
동국제강후문,36069,129,696,127,696,2,26
동국제강후문,36070,930,108,928,108,2,33
동남스포피아,38226,9928,7210,9906,7210,22,552
동남스포피아,38227,10398,8694,10350,8694,48,615
동남아파트,38267,1074,6145,1074,6145,0,232
동남아파트,38268,2797,1136,2797,1136,0,126
동남아파트,70039,542,594,538,594,4,36
동남아파트(무지개아파트),38337,1334,3853,994,3853,340,167
동녘개,90147,0,11,0,11,0,0
동녘개,90148,29,11,29,11,0,1
동녘마을입구,39660,39,705,39,705,0,24
동들머리,43705,12,7,12,7,0,0
동들머리,43885,14,47,14,47,0,1
동막교회,43499,6,36,6,36,0,1
동막교회,43514,32,4,30,4,2,1
동막역(1번출구),38039,37273,53212,37233,53212,40,2918
동막역(3번출구),38433,50386,28687,50354,28687,32,2550
동막역(4번출구),38338,9598,991,9595,991,3,341
동막초등학교,38054,937,3593,935,3593,2,146
동막해변,43408,61,112,61,112,0,5
동막해변,43511,149,46,149,46,0,6
동문아파트,42436,14083,13300,14067,13300,16,883
동방중학교,92038,270,318,270,318,0,18
동방초등학교,92037,19,148,19,148,0,5
동보2차아파트,41053,35,600,33,600,2,20
동보2차아파트,41059,879,99,869,99,10,31
동보노빌리티,35488,3370,3146,3370,3146,0,210
동보노빌리티,35489,3341,2711,3341,2711,0,195
동보아파트,39125,2697,5558,2697,5558,0,266
동보아파트,39126,5488,1731,5488,1731,0,232
동보아파트,41056,4032,567,4032,567,0,148
동보아파트,41063,741,3537,741,3537,0,138
동보아파트,41136,421,1057,414,1057,7,47
동보아파트,41143,12815,16716,12769,16716,46,952
동보아파트,70040,370,636,360,636,10,32
동보아파트후문,41129,1269,322,1265,322,4,51
동부아파트,36051,5532,1002,5475,1002,57,210
동부아파트,36052,1379,2614,1364,2614,15,128
동부아파트,37192,547,495,547,495,0,33
동산고,36018,11605,3515,11588,3515,17,487
동산고등학교,36021,4903,11327,4892,11327,11,523
동산교회,36010,1878,2867,1875,2867,3,153
동산교회,36012,3029,3715,3023,3715,6,217
동산교회,90303,3,5,3,5,0,0
동산리마을회관,90302,15,7,15,7,0,0
동산리입구,90291,8,9,8,9,0,0
동산중고등학교(인천재능대정문),36029,7313,957,7311,957,2,266
동산휴먼시아2단지,36022,2748,526,2745,526,3,105
동산휴먼시아2단지,36023,1044,4314,1042,4314,2,172
동서식품,40623,2614,2464,2606,2464,8,163
동서식품,40624,2048,3654,2045,3654,3,183
동성.길훈아파트,42495,3335,5290,3334,5290,1,278
동성아파트,42496,4572,2183,4569,2183,3,217
동수교회,40184,162,1154,158,1154,4,42
동수역,40108,3252,5457,3238,5457,14,280
동수역,40110,7457,5985,7423,5985,34,433
동수역,40124,1992,11562,1975,11562,17,437
동수치안센터,40188,8381,9018,8348,9018,33,561
동수치안센터,40189,11570,12398,11551,12398,19,773
동아.팬더아파트,39233,6897,10205,6877,10205,20,551
동아.팬더아파트,39236,10876,6104,10836,6104,40,547
동아2단지정문,40324,1425,467,1411,467,14,61
동아금호아파트,38344,5212,12643,5205,12643,7,575
동아금호아파트,38347,7503,2718,7490,2718,13,329
동아아파트,37248,939,1229,937,1229,2,69
동아아파트,41070,3021,904,2964,904,57,126
동아아파트,41072,698,2242,678,2242,20,94
동아아파트,41403,2533,4657,2531,4657,2,231
동아아파트,42404,3306,4062,3306,4062,0,237
동아아파트,42406,5629,2962,5629,2962,0,277
동아아파트후문,40257,2371,2837,2352,2837,19,168
동아아파트후문,40258,2682,1848,2659,1848,23,146
동아전기,42647,565,782,564,782,1,43
동아전기,42725,1060,862,1056,862,4,62
동아정밀,42037,1189,2607,1188,2607,1,122
동아풍림아파트,37037,14269,16804,14261,16804,8,1002
동암국민주택,40014,3422,810,3385,810,37,136
동암국민주택,40015,669,2053,665,2053,4,87
동암남부역,40034,40111,27735,40111,27735,0,2188
동암남부역,40797,130253,111795,129789,111795,464,7808
동암남부역,40861,803,6957,803,6957,0,250
동암남부역,40862,18990,13398,18987,13398,3,1044
동암북부역,40013,31337,15814,31256,15814,81,1521
동암북부역,40035,10433,30871,10404,30871,29,1332
동암북부역광장,40800,71029,54535,70638,54535,391,4050
동암사거리,40001,14093,15487,14082,15487,11,954
동암사거리,40003,3272,6199,3254,6199,18,305
동양도서관,41522,6172,3667,6157,3667,15,317
동양도서관(휴먼빌아파트),41523,3804,4665,3796,4665,8,273
동양엔파트4단지,42820,2505,4340,2502,4340,3,220
동양엔파트4단지,42837,4210,1883,4204,1883,6,196
동양엔파트5단지,42986,2583,3021,2581,3021,2,180
동양자이입구,41554,2487,3771,2482,3771,5,201
동양자이입구,41555,2708,2346,2707,2346,1,163
동양장사거리,37301,7897,6387,7866,6387,31,460
동양주공1.2단지,41372,11085,2990,11067,2990,18,454
동양주공1.2단지,41373,2762,7673,2748,7673,14,336
동양지구1단지정문,41521,602,1803,602,1803,0,77
동양지구입구,41445,4341,437,4328,437,13,154
동양지구입구,41446,1152,5802,1152,5802,0,224
동양하이테크,42966,26,224,26,224,0,8
동원로얄듀크마리나포레,35890,1231,594,1230,594,1,58
동원로얄듀크마리나포레,35891,394,1032,394,1032,0,46
동원아파트,25166,189,259,186,259,3,14
동원아파트,25167,378,130,375,130,3,16
동원아파트,37376,4743,1913,4739,1913,4,214
동원아파트,37379,1452,2695,1448,2695,4,133
동인천,35188,27370,34809,27370,34809,0,2005
동인천(우리은행앞),35517,538,368,515,368,23,29
동인천동행정복지센터,35795,19,390,19,390,0,13
동인천동행정복지센터,35805,78,120,78,120,0,6
동인천역,35185,102039,47080,101824,47080,215,4810
동인천역,35187,4961,10106,4920,10106,41,486
동인천역,35191,71214,87252,70914,87252,300,5111
동인천역,35192,10732,21944,10630,21944,102,1054
동인천역북광장,36136,24735,16525,24625,16525,110,1330
동인천역북광장,36137,30173,16489,30087,16489,86,1505
동인천중학교,39229,1546,740,1535,740,11,73
동인천중학교,39230,1690,1231,1675,1231,15,94
동일방직,36031,3551,3214,3529,3214,22,218
동일방직,36032,3399,2773,3379,2773,20,199
동일아파트,35177,502,1401,494,1401,8,61
동작세무서,20005,39,364,39,364,0,13
동주농장,43349,2,9,2,9,0,0
동주농장,43401,29,8,26,8,3,1
동촌,43407,105,0,99,0,6,3
동촌,43793,0,84,0,84,0,2
동춘2동행정복지센터,38045,1147,5999,1143,5999,4,230
동춘2동행정복지센터,38046,5292,689,5268,689,24,192
동춘동종점,38037,426,937,404,937,22,43
동춘동차고지,38569,625,317,599,317,26,30
동춘롤러경기장,38704,276,525,273,525,3,25
동춘마을아파트,38082,6403,5456,6375,5456,28,382
동춘마을아파트,38087,3476,6775,3475,6775,1,330
동춘역,38346,33936,22413,33866,22413,70,1817
동춘역(이마트),38060,14040,605,14040,605,0,472
동춘역(이마트.스퀘어원),38070,30431,39866,30425,39866,6,2267
돼지슈퍼.간동입구,80019,72,815,72,815,0,28
두두미마을,43289,10,0,10,0,0,0
두두미마을,43869,0,10,0,10,0,0
두밀경노당,89328,7,149,7,149,0,5
두밀경노당,89331,118,5,116,5,2,3
두산아파트,40564,2055,3656,2012,3656,43,184
두산위브아파트,37043,14318,8766,14308,8766,10,744
두산위브아파트,40630,11590,609,11572,609,18,393
두산위브아파트,40648,412,1208,412,1208,0,52
두운1리마을회관앞,90047,1,37,1,37,0,1
두운1리마을회관앞,90048,41,3,40,3,1,1
두운리,43034,77,56,76,56,1,4
두운리,43540,108,239,108,239,0,11
둑실경로당,41498,5,30,5,30,0,1
둑실경로당,41514,46,0,46,0,0,1
둑실동(아라마루전망대),41494,1,32,1,32,0,1
둑실동(아라마루전망대),41512,148,2,148,2,0,4
둑실동회차지,41500,40,15,40,15,0,1
둥개마을오거리,35861,0,50,0,50,0,1
둥개마을오거리,35862,32,0,32,0,0,1
둥깨마을입구(세븐일레븐),35721,23,34,23,34,0,1
둥깨마을입구(세븐일레븐),35722,85,20,84,20,1,3
둥깨마을입구(용성철강),35723,1,26,1,26,0,0
둥깨마을입구(용성철강),35724,2,2,2,2,0,0
뒤골입구,35668,44,0,44,0,0,1
뒤골입구,35669,3,42,3,42,0,1
뒷골 입구,90377,1,11,1,11,0,0
뒷골 입구,90380,27,0,27,0,0,0
뒷방죽들,39959,885,25,885,25,0,29
뒷방죽들,39960,5921,8014,5921,8014,0,449
드라이빙센터,35589,50,1841,50,1841,0,61
드림로갈산교,41342,250,59,246,59,4,9
드림로갈산교,41343,67,805,63,805,4,28
드림파크야생화단지,89363,1892,9,1813,9,79,61
드림파크야생화단지,89364,37,2032,7,2032,30,66
드무리해변,44011,20,506,19,506,1,16
드무리해변,44012,547,27,543,27,4,18
디에스솔텍,39035,3007,2286,3007,2286,0,170
디에스솔텍,39038,2131,2082,2131,2082,0,135
디에트로더힐,89455,4155,4900,4155,4900,0,292
디에트로더힐,89464,453,4,453,4,0,14
디에트르더힐(고산터널),89396,4021,6170,4021,6170,0,328
뗏마루어린이공원·신화아파트,39405,4606,6826,4564,6826,42,368
라마다 인천호텔,92075,196,1041,196,1041,0,39
라이크홈기숙사앞,39993,1544,1272,1544,1272,0,90
라이크홈기숙사앞,39994,2339,1560,2339,1560,0,125
라이크홈기숙사앞,39995,1004,51,1002,51,2,34
라이크홈기숙사앞,39996,32,406,27,406,5,14
라이프쇼핑앞,35070,5895,5584,5834,5584,61,370
라이프아파트,35060,139,5616,136,5616,3,185
라이프아파트,35062,13197,98,13131,98,66,428
"래미안아파트,파이낸셜뉴스",22905,6362,3863,6362,3863,0,329
래미안아파트파이낸셜뉴스,31072,899,2210,899,2210,0,100
래미안아파트파이낸셜뉴스,32002,2686,1730,2686,1730,0,142
랜드마크시티1호수변공원,38767,37,45,37,45,0,2
랜드마크시티센트럴더샵,38636,120,3407,120,3407,0,113
랜드마크시티센트럴더샵(106동),38665,954,7214,951,7214,3,263
랜드마크시티센트럴더샵(106동),38666,6470,716,6459,716,11,231
랜드마크시티센트럴더샵(203동),38645,15287,1145,15286,1145,1,530
랜드마크시티센트럴더샵(203동),38650,1254,13170,1253,13170,1,465
럭키아파트,23488,310,157,310,157,0,15
럭키아파트,38115,4280,161,4280,161,0,143
럭키아파트,38132,774,8234,774,8234,0,290
레이크파크,42840,1563,4074,1557,4074,6,181
레전드호텔,35639,1345,1770,1345,1770,0,100
레전드호텔,35640,49,330,49,330,0,12
레지던스라이크홈,92012,421,5323,421,5323,0,185
로봇랜드입구,89022,3409,75,3409,75,0,112
로봇랜드입구,89023,7,2264,7,2264,0,73
로봇타워,89301,3,487,3,487,0,15
로봇타워,89302,699,24,698,24,1,23
로얄금속,40599,5342,3256,5325,3256,17,277
로얄아파트,37247,32783,16473,32715,16473,68,1588
로얄아파트,37424,585,265,563,265,22,27
로얄타운,42047,1841,3262,1826,3262,15,164
로얄타운,42049,1911,1417,1903,1417,8,107
로얄타운,42050,2038,1588,2023,1588,15,116
로얄호텔,43542,13,20,13,20,0,1
로얄호텔,43878,5,17,5,17,0,0
롯데마트,35108,3433,4538,3427,4538,6,257
롯데마트,41390,742,22,742,22,0,24
롯데마트,41391,22,2465,22,2465,0,80
롯데마트,42829,18735,9677,18735,9677,0,916
롯데마트,42838,9612,19929,9612,19929,0,952
롯데마트계양점(고용복지센터),41227,26705,17219,26620,17219,85,1416
롯데마트계양점(고용복지센터),41424,10498,18979,10479,18979,19,950
롯데마트송도점,38523,2744,865,2743,865,1,116
롯데몰.김포공항,25174,350,1491,350,1491,0,59
롯데백화점(인천터미널),37513,180294,166292,179938,166292,356,11180
롯데백화점(인천터미널),39588,170308,122715,170048,122715,260,9452
롯데슈퍼,38072,9073,3010,9072,3010,1,389
롯데슈퍼,38074,2817,7646,2812,7646,5,337
롯데슈퍼,42206,2626,4206,2618,4206,8,220
롯데슈퍼,42207,6734,2287,6690,2287,44,291
롯데아파트,38110,7308,9649,7291,9649,17,547
롯데우람아파트,42152,4993,7126,4986,7126,7,390
롯데우람아파트,42603,3656,5380,3636,5380,20,291
롯데월드타워,37327,2652,4982,2643,4982,9,246
롯데캐슬,39795,503,268,503,268,0,24
롯데캐슬,39796,2874,1160,2874,1160,0,130
롯데캐슬,39797,532,114,532,114,0,20
롯데캐슬,39798,147,478,147,478,0,20
롯데캐슬,42835,7294,5484,7261,5484,33,412
롯데캐슬,42884,5463,10303,5459,10303,4,508
롯데캐슬,42999,887,2847,887,2847,0,120
롯데캐슬.모래내시장,39309,53983,19874,53844,19874,139,2382
롯데캐슬모래내시장,39310,28503,50846,28458,50846,45,2559
롯데캐슬캠퍼스타운,39977,5,829,5,829,0,26
롯데캐슬캠퍼스타운,39978,2420,2858,2420,2858,0,170
롯데캐슬후문,39285,4152,4307,4144,4307,8,272
루에블리아파트,89283,2318,4284,2312,4284,6,212
루에블리아파트,89284,6199,6244,6187,6244,12,401
루원더퍼스트아파트,89107,3734,6600,3724,6600,10,333
루원더퍼스트아파트,89108,8776,2059,8771,2059,5,349
루원더퍼스트아파트105동앞,89378,176,1102,176,1102,0,41
루원숲속마을,89383,337,1371,334,1371,3,55
루원숲속마을,89384,6,420,6,420,0,13
루원시티2차리더스뷰아파트,89072,13742,11695,13729,11695,13,820
루원시티사거리,89076,1629,1036,1616,1036,13,85
루원시티사거리,89077,382,1101,381,1101,1,47
루원시티프라디움,89150,14239,3958,14228,3958,11,587
루원시티프라디움105동,89308,8923,10432,8898,10432,25,624
루원시티프라디움105동,89309,3191,6200,3187,6200,4,302
루원이편한세상하늘채(107동),42225,12266,17278,12229,17278,37,953
루원이편한세상하늘채(112동),42721,4063,2017,4059,2017,4,196
루원이편한세상하늘채(125동),42216,4240,2257,4235,2257,5,209
루원제일풍경채정문앞,89040,3412,10422,3391,10422,21,446
루원중학교,89493,967,244,967,244,0,39
루원중학교,89494,32,442,32,442,0,15
루원지웰시티푸르지오,42228,9168,8514,9123,8514,45,570
루원호반베르디움,89149,4933,12674,4915,12674,18,567
루원호반베르디움104동,89368,968,1634,968,1634,0,83
리안월드입구,90177,34,12,34,12,0,1
리안월드입구,90178,13,28,12,28,1,1
린나이코리아,40011,7,371,5,371,2,12
린나이코리아,40012,399,2,399,2,0,12
린스트라우스,42881,8087,3487,8079,3487,8,373
린스트라우스정문,42795,6922,3764,6922,3764,0,344
린스트리우스,42831,3202,2978,3191,2978,11,199
마그네,43028,161,144,161,144,0,9
마그네다리,43158,188,144,188,144,0,10
마그네다리,43900,30,10,27,10,3,1
마그네사거리,43029,279,290,277,290,2,18
마그네사거리,43030,396,351,393,351,3,24
마니교통차고지,89496,219,8,219,8,0,7
마니산상회,43417,115,25,107,25,8,4
마니산상회,43443,30,99,30,99,0,4
마니산입구,43102,145,426,145,426,0,18
마니산입구,43103,577,191,573,191,4,24
마당개,35681,71,47,70,47,1,3
마당개,35697,52,22,52,22,0,2
마린월드,70004,885,175,856,175,29,34
마린월드,70029,10,90,1,90,9,3
마미,43747,18,17,18,17,0,1
마미,43765,2,8,2,8,0,0
마송,80131,886,4332,881,4332,5,168
마송,80132,3601,826,3583,826,18,142
마시란,35424,156,369,156,369,0,16
마시란,35425,419,76,419,76,0,15
마을금고,40528,2222,7210,2192,7210,30,304
마을회관,43314,19,0,19,0,0,0
마을회관,43773,0,5,0,5,0,0
마을회관입구,35024,543,1778,518,1778,25,74
마을회관입구,35402,995,225,995,225,0,39
마장공원,40286,6660,40,6599,40,61,216
마장포,35679,15,6,15,6,0,0
마장포,35699,245,82,217,82,28,10
마장포고개,35677,48,50,48,50,0,3
마장포고개,35701,80,27,80,27,0,3
마전고등학교,42752,96,7184,96,7184,0,234
마전고등학교,42753,5801,220,5801,220,0,194
마전역,42412,2856,8198,2854,8198,2,356
마전역,42413,19435,4687,19433,4687,2,778
마전주공아파트,42420,37,132,32,132,5,5
마전주공아파트,89322,0,1,0,1,0,0
마전지구1,42643,8366,57,8366,57,0,271
마전지구2,42645,10,4465,10,4465,0,144
마전지구3,42646,8,4943,8,4943,0,159
마전지구대원아파트,42481,5267,66,5267,66,0,172
마전지구대원아파트,89446,15,5104,15,5104,0,165
마전지구버스차고지,89259,3725,58,3725,58,0,122
마전지구버스차고지,89345,56,2450,56,2450,0,80
마전초등학교,42408,4551,5116,4551,5116,0,311
마포역,14001,4,491,4,491,0,15
마포역,14002,346,1,346,1,0,11
막촌,43460,287,16,274,16,13,9
막촌,43776,4,143,4,143,0,4
만석동행정복지센터,36046,3783,1606,3745,1606,38,173
만석부두,36076,438,3268,435,3268,3,119
만석부두,36079,4343,1496,4308,1496,35,188
만석비치타운,36106,566,7066,566,7066,0,246
만석비치타운,36126,1425,1068,1425,1068,0,80
만석삼거리,36185,2396,5357,2339,5357,57,250
만석삼거리,36186,862,1489,860,1489,2,75
만석주공,36057,14531,2404,14474,2404,57,546
만석초등학교,36056,686,179,674,179,12,27
만석초등학교,36187,0,136,0,136,0,4
만수1동행정복지센터,39294,12531,4912,12504,4912,27,562
만수2동행정복지센터·포레시안,39731,16621,9121,16618,9121,3,830
만수2동행정복지센터·포레시안,39735,10072,11340,10063,11340,9,690
만수3동주민센터,39425,18696,24738,18613,24738,83,1401
만수3동주민센터,39427,30924,12454,30875,12454,49,1399
만수3동주민센터,39544,472,158,471,158,1,20
만수3동주민센터,39545,96,979,95,979,1,34
만수4동주민센터,39452,6451,6619,6425,6619,26,421
만수4동주민센터,39454,6419,11538,6394,11538,25,579
만수6동주민센터입구,39277,4560,12729,4547,12729,13,557
만수7.8단지앞,39497,886,1965,882,1965,4,91
만수7.8단지앞,39635,2796,2209,2792,2209,4,161
만수고등학교,39680,2027,1744,2027,1744,0,121
만수고등학교,39681,2118,2261,2118,2261,0,141
만수북중학교,39468,999,1793,999,1793,0,90
만수북중학교,39469,2231,607,2231,607,0,91
만수북초등학교,39420,6039,4644,5982,4644,57,344
만수소방서,39428,8493,15110,8428,15110,65,761
만수소방서,39433,33231,12175,33106,12175,125,1464
만수신동아아파트·동인천고,39485,9860,9459,9264,9459,596,623
만수신동아아파트·동인천고,39578,418,30,394,30,24,14
만수역,39385,2590,50,2590,50,0,85
만수역,39388,366,18085,350,18085,16,595
만수종합시장,39451,28004,9421,27814,9421,190,1207
만수종합시장,39592,8671,21206,8589,21206,82,963
만수주공1단지,39401,3165,3254,3153,3254,12,207
만수주공320동앞,39431,1456,1879,1456,1879,0,107
만수주공4단지,39440,7958,5855,7937,5855,21,445
만수주공4단지,39443,10367,9372,10350,9372,17,636
만수주공정문,39408,10753,7976,10722,7976,31,604
만수주공정문,39410,2910,3550,2884,3550,26,208
만수주공후문,39435,4439,10646,4417,10646,22,486
만수주공후문,39438,13748,3913,13677,3913,71,569
만수중(대토단지),39400,281,1571,281,1571,0,59
만수중학교후문,39745,152,886,152,886,0,33
만수초등학교,39303,1624,4829,1622,4829,2,208
만수초등학교,39307,471,898,464,898,7,44
만수치안센터,39455,902,503,902,503,0,45
만월종합사회복지관,92065,6,1755,4,1755,2,56
만월중학교,39962,2422,360,2411,360,11,89
만월중학교,39963,154,2679,153,2679,1,91
만의골입구,39666,75,75,75,75,0,4
만의골입구,39672,3,49,3,49,0,1
만정낚시터,35682,99,60,99,60,0,5
만정낚시터,35696,39,57,38,57,1,3
만정낚시터입구,35683,32,77,32,77,0,3
만정낚시터입구,35695,89,68,86,68,3,5
망양돈대,90224,0,31,0,31,0,1
망양돈대,90225,22,3,22,3,0,0
망월3리,43332,148,116,132,116,16,8
망월3리,43580,0,21,0,21,0,0
망월입구,43117,5,0,5,0,0,0
망월입구,43576,27,43,27,43,0,2
망월입구,43790,4,15,4,15,0,0
망월종점,43788,10,15,7,15,3,0
매음1리마을회관,90173,24,29,24,29,0,1
매음1리마을회관,90174,19,10,18,10,1,0
매음3리마을회관(민머루),90321,10,14,9,14,1,0
매음3리마을회관(민머루),90322,4,0,4,0,0,0
매제미고개,43837,23,13,23,13,0,1
매제미고개,43988,2,17,2,17,0,0
먼우금사거리,38114,6638,4965,6621,4965,17,374
먼우금초등학교,38021,3203,10997,3203,10997,0,458
메이루즈커낼파크뷰,42747,3461,9182,3448,9182,13,407
메이루즈커낼파크뷰,42762,9961,3696,9941,3696,20,440
메이루즈커낼파크뷰정문,42794,3742,4040,3742,4040,0,251
메제미,43302,110,28,110,28,0,4
메제미,43598,29,106,29,106,0,4
면사무소입구,90018,4,117,3,117,1,3
면사무소입구,90019,110,8,100,8,10,3
면허시험장,39006,2942,2774,2942,2774,0,184
명가빌라(회차),37553,2306,2139,2249,2139,57,143
명보주택앞,43979,5,10,5,10,0,0
명보주택앞,43984,34,3,33,3,1,1
명신여자고등학교,40289,16447,4550,16440,4550,7,677
명신여자고등학교,40291,5110,11242,5097,11242,13,527
명신초등학교,43394,93,0,91,0,2,3
명신초등학교,43803,1,90,1,90,0,2
명진부페,43632,7,15,6,15,1,0
명현중학교,41405,2646,7998,2644,7998,2,343
명현초등학교,41559,5693,1872,5693,1872,0,244
명현초등학교,41560,1443,4028,1443,4028,0,176
명현초등학교(효성지구대),41069,3,1029,2,1029,1,33
모다아울렛,89190,2024,2833,2022,2833,2,156
모래내시장,39295,15023,13426,15011,13426,12,917
모래내시장,39298,13244,10786,13218,10786,26,775
모래내시장,39344,6750,6383,6750,6383,0,423
모래내시장,39350,11681,12962,11637,12962,44,794
모래내시장역(1번출구),39338,10883,9527,10858,9527,25,658
모래내시장역(2번출구),39909,9372,12295,9343,12295,29,698
모래내시장역(3번출구),39339,35412,33014,35316,33014,96,2207
모래내시장역(4번출구),39335,2253,5756,2237,5756,16,258
모래방죽사거리,89228,1388,1060,1384,1060,4,78
모래방죽사거리,89229,3063,2847,3063,2847,0,190
모름말,90255,6,0,4,0,2,0
모름말,90311,1,6,1,6,0,0
모리부락입구,90304,9,0,9,0,0,0
모아미래도,89344,2223,1435,2222,1435,1,118
모아아파트,70033,264,631,256,631,8,28
모아아파트.세종프라자,70034,645,258,630,258,15,29
모현,43659,3,209,3,209,0,6
모현,43689,221,8,217,8,4,7
목감IC진입(미정차),70226,2,0,2,0,0,0
목개마을,90153,12,10,12,10,0,0
목개마을,90154,33,7,30,7,3,1
목너머,35863,37,10,37,10,0,1
목너머,35864,2,31,2,31,0,1
목련어린이집,40824,10097,3484,10091,3484,6,438
목비고개,43032,56,105,52,105,4,5
목비고개,43272,141,96,141,96,0,7
목상교입구,41493,7,7,7,7,0,0
목상교입구,41519,1,31,1,31,0,1
목상교차로,41636,8,219,8,219,0,7
목상교차로,41637,156,2546,156,2546,0,87
목상동(새봄농원입구),41323,0,50,0,50,0,1
목상동(새봄농원입구),41324,27,9,27,9,0,1
목상동마을입구,41318,0,127,0,127,0,4
목상동마을입구,41517,89,17,89,17,0,3
목상동솔밭.이주단지입구,41316,675,47,669,47,6,23
목상동솔밭.이주단지입구,41317,47,545,45,545,2,19
목장앞,43503,3,5,3,5,0,0
목장앞,43688,8,3,8,3,0,0
목재단지,42036,346,624,346,624,0,31
목재부두사거리,42949,0,308,0,308,0,9
목재부두사거리,42960,82,31,82,31,0,3
목화빌라,37545,4,437,3,437,1,14
목화예식장,39446,14618,12777,14562,12777,56,883
목화예식장,39448,13681,19239,13642,19239,39,1061
무내미마을,39496,249,680,248,680,1,29
무내미마을,40106,149,2012,146,2012,3,69
무선내,44199,3,2,3,2,0,0
무의공영주차장,35871,1,14,1,14,0,0
무의도입구,35001,3008,175,2999,175,9,102
무의도입구,35002,449,3534,449,3534,0,128
무의도주민자치센터,35738,216,9,211,9,5,7
무의도주민자치센터,35739,11,123,11,123,0,4
무지개.한양8차아파트,40271,6924,4193,6916,4193,8,358
무지개.한양8차아파트,40276,5816,9498,5783,9498,33,494
무지개아파트,38366,3642,2733,3630,2733,12,205
무지개아파트(동남아파트),38042,5987,1050,5926,1050,61,227
무학리입구,90276,33,24,33,24,0,1
묵골,43498,22,16,15,16,7,1
묵골,43684,13,14,4,14,9,0
문남마을,38250,7842,5147,7834,5147,8,419
문남초등학교,38214,2609,2221,2602,2221,7,155
문남초등학교,38216,2537,3475,2528,3475,9,193
문말3거리,44084,9,0,9,0,0,0
문말삼거리,44001,267,25,258,25,9,9
문말삼거리,44002,22,242,20,242,2,8
문산교회앞,43005,80,61,79,61,1,4
문산교회앞,43340,14,39,14,39,0,1
문산교회앞,43589,32,23,31,23,1,1
문산리마을회관,43101,92,314,90,314,2,13
문일여고·하우스토리만수아파트,39313,1195,4463,1190,4463,5,182
문일여고·하우스토리만수아파트,39314,5721,786,5716,786,5,209
문일여자고등학교후문,39685,2155,3438,2151,3438,4,180
문학경기장(X게임장),37643,62,91,46,91,16,4
문학경기장(박태환수영장),38310,3302,1898,3291,1898,11,167
문학경기장(박태환수영장),38311,452,3479,451,3479,1,126
문학경기장(박태환수영장),38329,1044,1353,1042,1353,2,77
문학경기장(박태환수영장),38423,743,1288,742,1288,1,65
문학경기장(야구장),37144,2139,8044,2118,8044,21,328
문학경기장(월드컵경기장),37157,2959,7164,2944,7164,15,326
문학경로당,37087,5128,3004,5128,3004,0,262
문학경로당,37088,4505,3651,4505,3651,0,263
문학고개,37056,2892,2700,2892,2700,0,180
문학고개,37057,2891,3401,2891,3401,0,202
문학고개,37101,3371,3940,3354,3940,17,235
문학우체국,37520,3714,4840,3714,4840,0,275
문학우체국,37521,5156,2925,5156,2925,0,260
문학정보고입구,37107,3716,5277,3716,5277,0,290
문학정보고입구,37108,5834,1772,5834,1772,0,245
문학초등학교,37105,18724,7868,18593,7868,131,857
문학초등학교,37110,8452,14885,8435,14885,17,752
문현,43164,48,44,48,44,0,2
문현,43195,144,3,134,3,10,4
문현,43321,1,129,1,129,0,4
문화교회,40173,304,261,304,261,0,18
문화교회,40174,9944,11974,9886,11974,58,707
문화예술회관,39197,3260,5772,3237,5772,23,291
문화예술회관,39199,627,702,624,702,3,42
물류단지D블럭앞,35604,358,4,358,4,0,11
물류단지F블럭앞,35603,4,584,4,584,0,18
미관광장,38508,38,197,36,197,2,7
미관광장,38512,24,38,24,38,0,2
미단교회사거리,35664,27,25,27,25,0,1
미단교회사거리,35665,4,20,4,20,0,0
미도아파트,37446,1296,1435,1296,1435,0,88
미도아파트,41027,10247,3098,10227,3098,20,430
미도아파트,41028,3474,9677,3456,9677,18,424
미래빌라,36088,6671,865,6655,865,16,243
미래빌라,36089,1402,4775,1402,4775,0,199
미래타운1.2단지,40683,3855,19216,3833,19216,22,744
미래타운1.2단지,40684,14439,2465,14431,2465,8,545
미래타운5단지,40672,1087,3823,1081,3823,6,158
미래타운5단지501동,40662,5709,308,5709,308,0,194
미래타운5단지505동,40669,5609,3213,5582,3213,27,284
미래테크원,92015,2531,938,2529,938,2,111
미루지,43420,14,18,12,18,2,1
미루지,43522,21,13,20,13,1,1
미륭아파트,36138,3006,591,2997,591,9,116
미륭아파트,36139,823,3531,814,3531,9,140
미림극장,36008,3409,7958,3375,7958,34,366
미림극장,36009,8915,2672,8848,2672,67,373
미림극장입구,36141,287,532,286,532,1,26
미산초등학교,40378,7092,8999,7067,8999,25,519
미송초등학교,38654,16389,1145,16374,1145,15,565
미송초등학교(하행),38653,1971,7898,1966,7898,5,318
미주탕,42123,3271,10991,3244,10991,27,460
미주탕,42124,11424,5419,11331,5419,93,543
미추홀경찰서(장미아파트),37524,811,4250,811,4250,0,163
미추홀공원,38368,8796,3303,8785,3303,11,390
미추홀구청,37304,4516,3560,4506,3560,10,260
미추홀구청,37307,934,2366,921,2366,13,106
미추홀구청입구,37306,9328,17812,9321,17812,7,875
미추홀구청입구,37312,10004,10904,9992,10904,12,674
미추홀구평생학습관,37073,5989,5749,5989,5749,0,378
미추홀도서관·인천신월초등학교,39270,3643,8001,3622,8001,21,375
미추홀서사거리,37678,220,1220,220,1220,0,46
미추홀아파트,40250,193,456,193,456,0,20
미추홀아파트,40254,218,359,218,359,0,18
미추홀외고,39689,905,1060,905,1060,0,63
미추홀외고,39690,899,583,892,583,7,47
미추홀퍼스트(2단지),37220,8699,3908,8640,3908,59,406
미추홀퍼스트(2단지),37642,3882,8689,3857,8689,25,405
미추홀퍼스트2단지,37646,2751,558,2751,558,0,106
미추홀퍼스트3단지,37647,777,3384,777,3384,0,134
민머루해수욕장,90336,7,11,7,11,0,0
민방위교육장,38610,37,596,37,596,0,20
민방위교육장,38611,800,471,799,471,1,41
민방위교육장,39733,8207,2436,8204,2436,3,343
민방위교육장,39734,60,2290,60,2290,0,75
민방위교육장입구,41043,1671,6145,1650,6145,21,252
바로크아파트,42530,828,584,820,584,8,45
박공현,43228,44,3,39,3,5,1
박공현,43294,14,26,14,26,0,1
박문여자고등학교,39799,1131,192,1127,192,4,42
박문여자고등학교,39800,640,749,639,749,1,44
박문중학교,39844,667,308,667,308,0,31
박문중학교,39847,472,3359,472,3359,0,123
박문중학교정문,39860,3508,240,3508,240,0,120
박문중학교후문,39859,390,57,390,57,0,14
박물관앞,43668,17,131,16,131,1,4
박물관앞,43698,209,19,202,19,7,7
박촌마을입구,35670,140,0,140,0,0,4
박촌마을입구,35671,11,144,11,144,0,5
박촌역,41309,16587,20233,16504,20233,83,1187
박촌역,41310,16057,11319,16034,11319,23,883
반달마을.법원.검찰청,55014,1228,4302,1217,4302,11,178
반도유보라,42904,461,1578,461,1578,0,65
반도유보라,42905,2492,462,2492,462,0,95
반도유보라,42963,2200,654,2192,654,8,92
반도유보라,42985,3342,1522,3342,1522,0,156
반디모텔,44126,4,0,4,0,0,0
반찬단지,89426,340,221,340,221,0,18
반찬단지,89427,521,120,521,120,0,20
반포역,31034,232,2836,232,2836,0,98
반포역,31035,4071,104,4071,104,0,134
발산초등학교(풍림아이원),42433,101,83,101,83,0,5
발전소삼거리,44115,45,71,44,71,1,3
밝게,43990,34,1,34,1,0,1
밝게,43991,1,34,1,34,0,1
밤나무골,43022,90,85,80,85,10,5
밤나무골,43023,114,86,112,86,2,6
방개마을,90141,31,5,31,5,0,1
방개마을,90142,3,12,3,12,0,0
방아머리,62008,146,25,145,25,1,5
방아머리,62032,48,131,47,131,1,5
방아머리선착장,62007,17,276,17,276,0,9
방아머리제1주차장,62031,45,226,45,226,0,8
방아머리제1주차장,62041,322,44,319,44,3,11
방죽골,39763,2078,3039,2068,3039,10,165
방죽골,39764,684,1897,683,1897,1,83
방죽말,43027,79,75,79,75,0,4
방죽말,43214,23,94,22,94,1,3
방죽삼거리,39173,339,888,337,888,2,39
방죽삼거리,39174,470,408,467,408,3,28
방죽삼거리,42681,1982,405,1974,405,8,77
방죽삼거리,42683,801,1404,801,1404,0,71
방촌공원,40419,2982,3098,2979,3098,3,196
방축삼거리,36159,600,400,595,400,5,32
방축삼거리,36190,83,15,83,15,0,3
방파제입구,35048,2,612,2,612,0,19
방화동도시개발11단지,25026,686,60,686,60,0,24
방화중학교,25008,3409,34,3404,34,5,111
방화중학교,25009,20,741,20,741,0,24
배다리,35186,11402,19857,11376,19857,26,1008
배다리삼거리,36006,13787,7799,13723,7799,64,696
배다리삼거리,36007,7234,10898,7172,10898,62,584
배다리청과물시장,35184,3671,2781,3626,2781,45,208
배다리헌책방거리,36158,603,552,603,552,0,37
배수지입구,42774,600,10,585,10,15,19
백두아파트,42632,9238,6685,9219,6685,19,513
백련사입구,43419,21,70,20,70,1,2
백련사입구,43808,37,17,36,17,1,1
백련산입구,35773,4,0,4,0,0,0
백련산입구,35778,0,22,0,22,0,0
백마장입구,40389,10158,2950,10134,2950,24,422
백마장입구,40390,2491,9774,2491,9774,0,395
백마장입구,40399,19234,19116,19209,19116,25,1237
백마장입구,40407,9798,9541,9775,9541,23,623
백병원(송림패션몰),36151,411,139,408,139,3,17
백사장회센터,62033,34,113,31,113,3,4
백사장회센터,62039,188,19,182,19,6,6
백산아파트,38112,3908,5325,3852,5325,56,297
백산아파트,38113,4605,5082,4576,5082,29,312
백산아파트,38328,1866,1617,1866,1617,0,112
백석고가(하이마트),42381,5135,4598,5128,4598,7,313
백석고가(하이마트),42578,4557,3936,4549,3936,8,273
백석마을,35096,39,45,39,45,0,2
백석중.고등학교,42374,6854,4083,6842,4083,12,352
백석중.고등학교,42375,5088,6695,5088,6695,0,380
백석중사거리,89238,1239,2032,1238,2032,1,105
백석중사거리,89239,323,4681,323,4681,0,161
백승아파트,41383,75,716,74,716,1,25
백승아파트,41384,118,242,118,242,0,11
백암왕순대앞,38483,2563,2006,2557,2006,6,147
백영아파트,40058,12426,4736,12408,4736,18,553
백영아파트,41361,8708,56,8708,56,0,282
백운곡,43040,179,97,176,97,3,8
백운곡,43295,91,194,91,194,0,9
백운공원,40072,15,656,14,656,1,21
백운공원(부평아트센터),40075,625,4002,625,4002,0,149
백운공원(부평아트센터),40076,2918,1430,2905,1430,13,140
백운역,40079,14256,21717,14225,21717,31,1160
백운역,40080,24780,18977,24751,18977,29,1411
백운역,40081,59904,54573,59824,54573,80,3692
백운역,40716,13877,3148,13856,3148,21,549
백운역(파출소),40094,96,1951,96,1951,0,66
백운역(하행),40901,2845,9207,2845,9207,0,388
백운프라자,37181,3993,10159,3974,10159,19,456
백운프라자,37185,7756,4490,7724,4490,32,395
백조세탁소,40282,1415,1528,1415,1528,0,94
백조세탁소,40285,1389,1016,1389,1016,0,77
백조아파트,40386,355,668,355,668,0,33
백조아파트,40388,1407,768,1407,768,0,70
뱅뱅사거리,31012,4,1759,4,1759,0,56
뱅뱅사거리,32001,1917,13,1917,13,0,62
버드러지,43428,8,8,8,8,0,0
버드러지,43476,81,44,78,44,3,4
번영로제1사거리,39113,617,1443,616,1443,1,66
번영로제3사거리,39036,707,287,707,287,0,32
번영로제3사거리,39037,234,1167,234,1167,0,45
벌말,43175,1,44,1,44,0,1
벌말,43297,59,0,58,0,1,1
벌판마을입구,35763,18,159,18,159,0,5
벌판마을입구,35764,135,90,134,90,1,7
범양상가,42118,4132,9790,4129,9790,3,449
범양상가,42122,8958,2317,8932,2317,26,363
범양아파트,42116,8789,2614,8754,2614,35,367
범양아파트(종점),42127,128,3,128,3,0,4
범허리종점,43974,63,37,59,37,4,3
법원,37130,281,2034,281,2034,0,74
법원,37131,1891,997,1891,997,0,93
법원.검찰청,37074,7751,5720,7722,5720,29,434
법원.검찰청.복사골문화센터.반달마을,55020,4537,1883,4514,1883,23,207
법원검찰청입구,37078,3464,4560,3460,4560,4,258
베어즈베스트골프장,89268,420,933,420,933,0,43
베어즈베스트골프장,89269,229,2591,229,2591,0,90
베어즈베스트청라GC,89046,48,138,48,138,0,6
베어즈베스트청라GC,89047,47,145,45,145,2,6
벧엘교회,39740,135,1338,135,1338,0,47
벽산.이삭아파트,39453,19372,23921,19365,23921,7,1396
벽산1차아파트,70023,173,1775,171,1775,2,62
벽산1차아파트,70024,2218,325,2213,325,5,82
벽산아파트,39459,1667,30,1652,30,15,54
벽산아파트,39549,16,3410,14,3410,2,110
벽산아파트(미추홀도서관),39273,11750,3879,11689,3879,61,504
벽산이삭아파트,39458,19598,12679,19574,12679,24,1041
별립산입구,43588,4,147,4,147,0,4
별립산입구,43778,60,1,55,1,5,1
병무청(학익풍림아이원),37013,20,15,20,15,0,1
병무청(학익풍림아이원),37671,25,949,25,949,0,31
병방사거리,41301,627,3009,616,3009,11,117
병방사거리,41303,5686,2106,5639,2106,47,251
병방초등학교,41302,495,876,494,876,1,44
병방초등학교,41304,1509,1324,1506,1324,3,91
병방초등학교(계양산전통시장),41299,15494,11628,15451,11628,43,874
보건소,43318,7,4,7,4,0,0
보건소,43626,2,38,1,38,1,1
보건환경연구원,35158,2162,1855,2162,1855,0,129
보라매역.동작세무서,19013,235,17,235,17,0,8
보람프라자앞,42442,30188,16991,30167,16991,21,1521
보릿고개,43517,54,404,53,404,1,14
보릿고개,43880,257,126,253,126,4,12
보무기,90165,17,31,17,31,0,1
보무기,90166,29,17,29,17,0,1
보문사,90206,1373,1201,1338,1201,35,83
보스턴힐,89461,198,858,198,858,0,34
보스턴힐,89462,454,578,454,578,0,33
보트비,89424,27,259,27,259,0,9
보트비,89425,93,89,93,89,0,5
보훈회관,39484,4481,7522,4472,7522,9,387
복사골문화센터.한아름마을,55026,1724,3374,1719,3374,5,164
복지회관,38079,2741,1236,2738,1236,3,128
복지회관,38080,1130,4322,1118,4322,12,175
본향교회,39164,12146,2463,12105,2463,41,471
볼보트럭남인천사업소,35814,1168,1122,1168,1122,0,73
봉골,43535,27,11,27,11,0,1
봉골,43673,14,28,14,28,0,1
봉성(오상2리),43261,0,47,0,47,0,1
봉성(오상2리),43377,87,0,81,0,6,2
봉소리마을회관,43000,69,11,66,11,3,2
봉소리마을회관,90001,20,48,20,48,0,2
봉수초등학교,42980,1373,1524,1373,1524,0,93
봉수초등학교,42981,21,655,21,655,0,21
부개1동행정복지센터,40191,2449,6288,2445,6288,4,281
부개1동행정복지센터,40193,6815,4225,6767,4225,48,356
부개2동행정복지센터,40323,2742,902,2742,902,0,117
부개2파출소,40317,820,540,820,540,0,43
부개2파출소,40318,3695,8924,3647,8924,48,407
부개2파출소,40329,4924,2116,4883,2116,41,227
부개2파출소,40764,75,195,75,195,0,8
부개3동행정복지센터,40494,1676,311,1635,311,41,64
부개3동행정복지센터입구,40486,252,1274,241,1274,11,49
부개6단지후문.웅진플레이,55021,43,1909,43,1909,0,62
부개고입구,40345,2939,5082,2914,5082,25,258
부개고입구,40783,6405,2481,6373,2481,32,286
부개농협,40199,426,2135,419,2135,7,82
부개농협,40201,2446,1022,2407,1022,39,111
부개사거리,40923,478,2217,470,2217,8,86
부개서초등학교,40243,5983,1243,5983,1243,0,233
부개성일아파트,40293,6496,2893,6491,2893,5,302
부개성일아파트,40301,5442,9630,5422,9630,20,486
부개여자고등학교,40421,2887,1456,2877,1456,10,140
부개여자고등학교,40422,1941,2620,1937,2620,4,147
부개여자고등학교,40423,8210,5390,8203,5390,7,438
부개여자고등학교,40428,3561,5805,3561,5805,0,302
부개역,40222,1143,4822,1137,4822,6,192
부개역,40223,7130,3124,7094,3124,36,330
부개역,40256,33573,18025,33473,18025,100,1664
부개우체국,40458,8931,6935,8918,6935,13,511
부개종합시장,40504,8925,3359,8874,3359,51,396
부개주공2단지,40772,610,684,607,684,3,41
부개주공3단지,40479,2772,1173,2770,1173,2,127
부개주공3단지정문,40460,395,757,395,757,0,37
부개주공3단지후문,40500,3647,6142,3631,6142,16,315
부개주공6단지,40442,3802,2406,3794,2406,8,200
부개주공6단지,40459,4250,4252,4250,4252,0,274
부개주공7단지,40385,9061,3827,9058,3827,3,415
부개주공7단지,40387,4203,6346,4199,6346,4,340
부광여자고등학교,40471,393,1541,393,1541,0,62
부광초등학교,40434,1502,4179,1483,4179,19,183
부광초등학교,40440,5554,1938,5496,1938,58,241
부근삼거리,43586,555,73,551,73,4,20
부근삼거리,43652,94,415,92,415,2,16
부근삼거리,90403,0,29,0,29,0,0
부근삼거리,90404,29,7,29,7,0,1
부대아래,90106,6,13,5,13,1,0
부대아래,90107,29,0,28,0,1,0
부대앞,18392,179,3,175,3,4,5
부대앞,18397,3,57,3,57,0,1
부대앞,38594,102,343,102,343,0,14
부대앞,41321,156,395,155,395,1,17
부대앞,41322,306,1064,306,1064,0,44
부대앞,41531,35,128,35,128,0,5
부대앞,41532,141,136,141,136,0,8
부대앞,42342,492,754,492,754,0,40
부대앞,42343,167,432,167,432,0,19
부대앞,43435,44,23,44,23,0,2
부대앞,43787,69,30,69,30,0,3
부동산입구,38278,3270,1874,3270,1874,0,165
부동산입구,38743,213,667,213,667,0,28
부명고.순천향대학병원,55036,2037,6518,2036,6518,1,275
부원여중·동아아파트,40202,5469,2200,5384,2200,85,247
부원여중·동아아파트,40208,1140,4329,1125,4329,15,176
부원중학교,40181,26369,15938,26232,15938,137,1364
부원중학교,40789,11672,29729,11645,29729,27,1335
부일여자중학교,40123,13880,2306,13852,2306,28,522
부천IC,57023,2481,2735,2481,2735,0,168
부천IC,57025,3817,2661,3817,2661,0,208
부천시청역1번출구,55061,1767,460,1767,460,0,71
부천시청역2번출구.현대백화점.이마트,55054,17968,9020,17955,9020,13,870
부천시청역3번출구.경기예고.현대백화점,55057,5795,8580,5789,8580,6,463
부천시청역4번출구.현대백화점.경기예고,55059,7858,5742,7844,5742,14,438
부천시청역5번출구,55060,723,3286,723,3286,0,129
부천실내체육관,55075,978,1876,975,1876,3,92
부천오정물류단지(중),57042,456,1039,456,1039,0,48
부천오정물류단지(중),57043,579,921,579,921,0,48
부천자동차검사소,57017,986,1549,986,1549,0,81
부천자동차검사소,57041,1195,1750,1195,1750,0,95
부천터미널소풍,55051,3018,8621,3009,8621,9,375
부천테크노파크1.2단지,57001,1408,1926,1405,1926,3,107
부천테크노파크1단지,57003,1852,2009,1852,2009,0,124
부평2동행정복지센터,40134,927,233,927,233,0,37
부평2동행정복지센터,40745,155,1195,155,1195,0,43
부평4동성당,40377,3541,2656,3525,2656,16,199
부평4동성당,40922,3375,2904,3364,2904,11,202
부평6동우체국,40186,1233,467,1224,467,9,54
부평6동행정복지센터,40906,6545,286,6532,286,13,220
부평LH1(2)단지,40160,5987,7557,5952,7557,35,436
부평LH1(2)단지,40161,5128,4295,5102,4295,26,303
부평감리교회,40148,1176,565,1176,565,0,56
부평경찰서,40468,46240,17663,46216,17663,24,2061
부평경찰서,40794,14727,39225,14709,39225,18,1740
부평구보건소,40372,5946,1960,5946,1960,0,255
부평구보건소,40373,2276,6706,2276,6706,0,289
부평구보건소,40858,2225,2144,2203,2144,22,140
부평구보건소,40890,2845,3950,2795,3950,50,219
부평구자활센터,40651,17339,1995,17339,1995,0,623
부평구자활센터,40658,476,9892,470,9892,6,334
부평구청,40462,37041,26864,36971,26864,70,2061
부평구청,40482,5924,4346,5913,4346,11,331
부평구청,40484,4510,5198,4506,5198,4,313
부평구청,40492,4902,17113,4892,17113,10,710
부평구청·부평세무서,40451,29255,36813,29230,36813,25,2131
부평구청역,40841,20815,5319,20807,5319,8,843
부평기적의도서관,40497,5778,3940,5768,3940,10,313
부평기적의도서관.삼부한신아파트,40490,3298,3261,3286,3261,12,211
부평남부역,40169,3615,5505,3594,5505,21,294
부평남부역입구,40170,6381,2759,6362,2759,19,294
부평남초등학교,40141,2867,2498,2845,2498,22,173
부평남초등학교앞,40136,2774,3285,2760,3285,14,195
부평농장,39772,127,759,127,759,0,28
부평농장사무소,39483,1371,2067,1371,2067,0,110
부평농장의원입구,39494,264,475,264,475,0,23
부평도서관,40082,4380,4405,4375,4405,5,283
부평도서관,40084,2728,4969,2726,4969,2,248
부평동중,40406,3088,2947,3082,2947,6,194
부평동중,55009,3475,2621,3472,2621,3,196
부평래미안아파트,40437,2620,3874,2620,3874,0,209
부평래미안아파트,40438,5709,2457,5709,2457,0,263
부평북초등학교,40656,1371,629,1371,629,0,64
부평북초등학교,40657,887,3262,887,3262,0,133
부평사거리,40073,2772,5736,2754,5736,18,274
부평사거리,40074,12150,8087,12106,8087,44,652
부평사거리,40887,1414,5640,1400,5640,14,227
부평삼거리,39489,11333,9355,11286,9355,47,667
부평삼거리역,39491,3836,1893,3836,1893,0,184
부평삼거리역,40066,10436,9286,10406,9286,30,636
부평샬레아파트(세일고등학교),40260,1654,7754,1651,7754,3,303
부평샬레아파트(세일고등학교),40263,5593,1998,5585,1998,8,244
부평서중,40092,677,638,677,638,0,42
부평서중,40095,262,791,262,791,0,33
부평시장,40262,57049,27599,56927,27599,122,2730
부평시장,40264,23018,37257,22985,37257,33,1944
부평시장,40265,12803,7173,12784,7173,19,644
부평시장,40283,16995,11478,16962,11478,33,918
부평시장,40290,10738,8179,10704,8179,34,610
부평시장(가구의거리),40295,26092,25541,26007,25541,85,1665
부평시장(가구의거리),40296,29758,10302,29632,10302,126,1292
부평시장(당약국),40303,1115,1334,1115,1334,0,79
부평시장(용갈비),40344,6471,516,6471,516,0,225
부평시장(한남프라자),40259,15776,11182,15716,11182,60,869
부평시장(한라비발디),40328,6254,2668,6183,2668,71,287
부평시장(한라비발디),40336,9927,16763,9911,16763,16,860
부평시장역,40361,18777,50425,18736,50425,41,2232
부평시장역(부평대로우체국),40368,35359,15235,35297,15235,62,1632
부평시장입구,40288,5231,8808,5185,8808,46,452
부평시장입구(2번출구),40309,8496,11157,8464,11157,32,633
부평아트센터,40078,2504,1234,2499,1234,5,120
부평아트센터,40709,1335,3853,1319,3853,16,167
부평여자고등학교,40365,3922,1365,3882,1365,40,170
부평여자고등학교,40410,5122,6909,5084,6909,38,388
부평여자고등학교,40793,7298,7670,7273,7670,25,482
부평여자중학교,40342,279,600,277,600,2,28
부평여자중학교,40726,383,470,383,470,0,27
부평역,40190,10001,45826,9984,45826,17,1800
부평역,40209,59739,55158,59543,55158,196,3706
부평역,40226,27568,18756,27568,18756,0,1494
부평역,40228,39402,37475,39359,37475,43,2479
부평역,40234,15991,40916,15957,40916,34,1835
부평역,40237,15666,6320,15617,6320,49,709
부평역,40239,8954,9873,8954,9873,0,607
부평역(12번출구),40781,35199,74223,35097,74223,102,3529
부평역(27번출구),40224,40773,7225,40508,7225,265,1548
부평역(CU편의점),40192,37949,3906,37860,3906,89,1350
부평역(대한극장),40196,15051,56023,15015,56023,36,2292
부평역(로터스프라자),40246,21128,27657,21087,27657,41,1573
부평역(북인천우체국),40197,50327,32733,50259,32733,68,2679
부평역사박물관,40597,227,636,226,636,1,27
부평역사박물관,40609,1013,255,1013,255,0,40
부평역사박물관,40798,462,177,462,177,0,20
부평역화성파크드림아파트,40804,1193,3946,1164,3946,29,165
부평역화성파크드림아파트,40805,4925,1258,4871,1258,54,199
부평우체국,40430,4022,4876,4015,4876,7,287
부평우체국,40432,5756,4537,5734,4537,22,332
부평우체국,40443,375,255,372,255,3,20
부평윤산부인과,40478,448,350,428,350,20,25
부평윤산부인과,40768,333,1653,321,1653,12,64
부평자이,40871,119,891,119,891,0,32
부평정수장,40647,1668,3380,1665,3380,3,162
부평제이타워3차지식산업센터,40644,3625,2661,3616,2661,9,202
부평중앙침례교회,40481,147,1018,146,1018,1,37
부평중학교,40402,4767,4067,4767,4067,0,284
부평중학교,40416,3980,4377,3980,4377,0,269
부평코오롱아파트106동,40404,801,996,796,996,5,57
부평코오롱하늘채아파트,40357,614,754,614,754,0,44
부평코오롱하늘채아파트,40360,1254,687,1254,687,0,62
부평테크노타워,40615,1696,1725,1693,1725,3,110
부평테크노타워,40616,2211,3359,2205,3359,6,179
부현동초등학교,41175,9933,4356,9876,4356,57,460
부흥로터리,40412,1513,2278,1489,2278,24,122
부흥오거리(부흥아파트),40392,5687,5616,5652,5616,35,364
부흥오거리(부흥아파트),40394,6337,4350,6311,4350,26,344
부흥오거리(소망병원),40374,5431,9129,5409,9129,22,469
부흥오거리(소망병원),40375,14093,10024,14055,10024,38,777
부흥초교,40302,8162,1698,8127,1698,35,318
부흥초등학교,40299,3538,8290,3509,8290,29,381
부흥초등학교,40304,12490,6414,12468,6414,22,609
북구도서관,40469,3100,3232,3100,3232,0,204
북동삼거리,62001,349,41,346,41,3,12
북동삼거리,62002,66,424,62,424,4,15
북변환승센터.구터미널,80080,609,61,609,61,0,21
북변환승센터.구터미널,80081,1,192,1,192,0,6
북성교회,43744,14,14,10,14,4,0
북성교회,43764,7,9,5,9,2,0
북성마을,43136,123,13,120,13,3,4
북성마을,43528,34,85,34,85,0,3
북인천여자중학교,41007,6882,5143,6846,5143,36,387
북인천여자중학교,41008,5839,6589,5828,6589,11,400
북인천여자중학교,41015,796,14092,789,14092,7,480
북인천여자중학교,41016,8289,271,8252,271,37,276
북항다목적부두,89208,25,1445,25,1445,0,47
북항다목적부두,89209,1204,17,1204,17,0,39
북항배후단지입구,89343,16,573,16,573,0,19
북항배후로입구,89414,0,79,0,79,0,2
북항사업소,89210,8,1385,8,1385,0,44
북항사업소,89211,1136,13,1136,13,0,37
북항입구,89304,445,1275,444,1275,1,55
북항입구,89305,1139,162,1136,162,3,41
분오리어판장,43406,30,14,27,14,3,1
분오리어판장,43495,5,60,5,60,0,2
분오저수지,43493,2,22,2,22,0,0
분오저수지,43509,31,1,31,1,0,1
불로대곡동행정복지센터,42497,947,1072,943,1072,4,65
불로대곡동행정복지센터,42498,955,2380,952,2380,3,107
불로중학교,42648,177,592,176,592,1,24
불로중학교,42652,310,527,310,527,0,27
불은면주민센터,43035,647,455,633,455,14,35
불은초등학교,43293,43,4,40,4,3,1
불은초등학교,43530,14,33,12,33,2,1
불은파출소,43036,537,781,532,781,5,42
붉은노리삼거리,44112,78,89,69,89,9,5
붉은노리삼거리,44173,14,0,11,0,3,0
브라운스톤.엠코타운아파트,40659,14156,18531,14143,18531,13,1054
블랙트리캠핑장,44124,9,30,9,30,0,1
블랙트리캠핑장,44174,13,0,13,0,0,0
블루오션골프클럽(앰코코리아),39879,8,1040,8,1040,0,33
비류마을,38261,1949,1915,1949,1915,0,124
비선삼거리,43113,3,7,3,7,0,0
비선삼거리,43114,20,2,20,2,0,0
비선삼거리,43547,247,314,244,314,3,18
비선삼거리,43596,181,135,172,135,9,10
비재고개,35420,282,75,282,75,0,11
비재고개,35421,73,296,73,296,0,11
비전교회,44200,2,8,2,8,0,0
비젼교회,40171,3374,2247,3351,2247,23,181
빈정공원,42571,1787,811,1786,811,1,83
빈정공원,42670,472,837,472,837,0,42
빈정내사거리,42327,1625,3039,1625,3039,0,150
빈정내사거리,42329,778,629,778,629,0,45
사랑마을벽산.선경.삼익아파트,55030,1937,1253,1931,1253,6,102
사리울삼거리,39128,3688,5132,3683,5132,5,284
사리울삼거리,39131,3033,2399,3030,2399,3,175
사리울중학교,39838,1755,4434,1754,4434,1,199
사리울중학교,39924,7008,1564,6995,1564,13,276
사리울초등학교후문,39713,5150,947,5136,947,14,196
사슴농장,43531,77,0,66,0,11,2
사슴농장,43866,0,37,0,37,0,1
사시미재,35731,38,4,35,4,3,1
사시미재,35732,3,47,3,47,0,1
사업.행정지원센터,35607,682,3,681,3,1,22
사업.행정지원센터,35608,37,694,37,694,0,23
사우고.김포고(걸포사거리방면),80064,4,1050,4,1050,0,34
사우고.김포시청,80024,160,2301,160,2301,0,79
사우고교.김포시청(직행),80377,1010,84,1010,84,0,35
사우역.김포고,35246,3257,799,3257,799,0,130
사우역.김포고(김포초교방면),80380,1583,2803,1583,2803,0,141
사원아파트입구,42777,108,108,105,108,3,6
사일로벽화,35163,31,2261,31,2261,0,73
사일로벽화,35167,1358,154,1353,154,5,48
사조해표,42019,2020,1981,2017,1981,3,129
사조해표,42020,983,1703,982,1703,1,86
사직(해나무),43416,0,31,0,31,0,1
사직(해나무),43797,57,0,54,0,3,1
사촌,43597,87,2,84,2,3,2
사촌,43785,0,22,0,22,0,0
삭은다리한국지엠,40524,196,2443,192,2443,4,85
삭은다리한국지엠,40525,3322,1998,3309,1998,13,171
산곡3동행정복지센터,40156,3223,461,3215,461,8,118
산곡교회,40383,8703,3253,8583,3253,120,385
산곡남초등학교,40227,1251,73,1251,73,0,42
산곡동입구(롯데마트),40779,163,1620,157,1620,6,57
산곡동입구(롯데마트),40785,12681,21110,12619,21110,62,1090
산곡동주안빌딩,40313,14261,2543,14199,2543,62,542
산곡동천주교회,40473,18654,13116,18586,13116,68,1024
산곡동천주교회,40476,9773,27965,9698,27965,75,1217
산곡여자중학교,40198,6994,8028,6941,8028,53,484
산곡여자중학교,40203,2587,4190,2578,4190,9,218
산곡여자중학교,40215,59,1599,59,1599,0,53
산곡여자중학교,40216,5031,138,5029,138,2,166
산곡여자중학교(마장로삼거리),40911,911,1404,906,1404,5,74
산곡역(1번출구),40420,5763,24888,5747,24888,16,988
산곡역(3번출구),40856,11806,5706,11782,5706,24,564
산곡역(6번출구),40429,12269,21122,12224,21122,45,1077
산곡역(7번출구),40425,53095,35195,53048,35195,47,2848
산곡중학교,40320,520,142,520,142,0,21
산곡중학교,40322,118,1151,118,1151,0,40
산곡한양7차,40354,124,9851,117,9851,7,321
산뒤,43235,25,106,25,106,0,4
산뒤,43887,117,19,111,19,6,4
산림조합앞,90234,13,29,9,29,4,1
산림조합앞,90235,7,127,6,127,1,4
산마루집,41497,6,44,6,44,0,1
산마루집,41513,68,0,68,0,0,2
산마을고등학교,43116,0,8,0,8,0,0
산마을고등학교,43599,30,5,30,5,0,1
산문입구,43107,87,181,85,181,2,8
산문입구,43286,163,165,162,165,1,10
산문입구,43899,10,1,10,1,0,0
산문종점,43154,41,104,41,104,0,4
산애들애,43143,3,2,3,2,0,0
산애들애,43492,4,2,4,2,0,0
산업단지사거리,36095,59,4140,59,4140,0,135
산업단지사거리,36098,5155,7445,5139,7445,16,406
산업단지사거리,37460,6165,299,6164,299,1,208
산업용품센타,42524,5744,497,5726,497,18,201
산업용품센타,42525,21,2580,20,2580,1,83
산업용품유통센타23동,36096,308,1966,308,1966,0,73
산업용품유통센타31동,36097,132,1781,130,1781,2,61
산업용품유통센타39동,36099,223,1722,221,1722,2,62
산업용품유통센터,36156,713,3,699,3,14,23
산업용품유통센터1동,36146,1917,404,1917,404,0,74
산업용품유통센터39동,36157,139,7,138,7,1,4
산업용품유통센터C동,36101,1804,25,1804,25,0,59
산우리고개,43337,2,6,2,6,0,0
산우리고개,43850,9,15,8,15,1,0
산음입구,80004,7,432,7,432,0,14
산음입구,80005,105,7,103,7,2,3
산촌마을,43217,2,2,2,2,0,0
산촌마을,43308,30,5,28,5,2,1
산호아파트앞,80059,1319,215,1319,215,0,49
산화고개,43271,170,38,165,38,5,6
산화고개,43388,36,200,31,200,5,7
삼덕아파트,37403,747,800,747,800,0,49
삼덕아파트,37404,489,958,489,958,0,46
삼동암리마을회관,43169,1,19,1,19,0,0
삼동암리마을회관,43227,29,4,24,4,5,1
삼라마이다스아파트,89317,210,9,210,9,0,7
삼라마이다스아파트,89323,3,95,3,95,0,3
삼목사거리,35088,1,25,1,25,0,0
삼목선착장,35311,252,671,251,671,1,29
삼목선착장(운서역행),35077,1141,253,1138,253,3,44
삼목선착장입구,35058,0,21,0,21,0,0
삼목선착장입구,35059,1,8,1,8,0,0
삼목초등학교,35310,1727,1726,1726,1726,1,111
삼목초등학교,35341,3256,2023,3251,2023,5,170
삼미시장,70172,670,3111,670,3111,0,121
삼미시장,70173,3240,687,3240,687,0,126
삼미타운,40172,5324,5720,5304,5720,20,356
삼보새마을금고,40796,8972,853,8970,853,2,316
삼보아파트,40298,2743,168,2743,168,0,93
삼보아파트,40308,12478,4432,12457,4432,21,545
삼보아파트,40677,8153,463,8147,463,6,277
삼보아파트,40679,462,7217,462,7217,0,247
삼보아파트,40786,4960,18888,4953,18888,7,769
삼보아파트,42350,2712,5153,2712,5153,0,253
삼보아파트,42351,6517,1810,6516,1810,1,268
삼보아파트(계양구청),41205,4226,8465,4206,8465,20,409
삼산경찰서,40584,1132,3019,1132,3019,0,133
삼산경찰서,40766,1765,2981,1765,2981,0,153
삼산고등학교(미래타운3단지),40689,11980,2537,11977,2537,3,468
삼산고등학교(미래타운4단지),40686,4972,8923,4941,8923,31,448
삼산군립어린이집,90171,7,9,6,9,1,0
삼산군립어린이집,90172,28,15,28,15,0,1
삼산글로리병원,40527,8053,6803,8041,6803,12,479
삼산농산물시장,40687,1694,4218,1686,4218,8,190
삼산동차고지,40830,94,5,91,5,3,3
삼산면사무소,90149,58,56,58,56,0,3
삼산면사무소,90150,89,72,83,72,6,5
삼산사거리,40638,6094,11553,6090,11553,4,569
삼산사거리,40690,3287,811,3287,811,0,132
삼산사거리,40691,8605,4632,8605,4632,0,427
삼산사거리,40924,310,2334,310,2334,0,85
삼산사거리(한국아파트),40646,4198,13727,4198,13727,0,578
삼산사거리.한국아파트,40645,6730,2019,6730,2019,0,282
삼산새마을금고,40668,730,9306,729,9306,1,323
삼산서해그랑블,40589,1564,2129,1546,2129,18,119
삼산서해아파트,40613,2859,831,2830,831,29,119
삼산월드체육관,40532,8589,2797,8581,2797,8,367
삼산월드체육관,40535,1566,1385,1562,1385,4,95
삼산월드체육관,40543,64,4607,64,4607,0,150
삼산월드체육관,40571,1816,2574,1812,2574,4,141
삼산월드체육관(삼산주공6단지),40802,973,2166,965,2166,8,101
삼산저수지앞,90245,1,2,1,2,0,0
삼산저수지앞,90246,1,1,1,1,0,0
삼산주공1단지,40780,1916,37,1913,37,3,63
삼산주공1단지(상가앞),40908,7115,564,7115,564,0,247
삼산주공4단지,40591,813,1729,813,1729,0,82
삼산주공7단지,40547,7390,7365,7374,7365,16,475
삼산주공7단지,40801,7658,8506,7627,8506,31,521
삼산중학교,40636,1531,820,1531,820,0,75
삼산중학교,40637,921,1131,921,1131,0,66
삼산체육관역(호수공원),40536,11079,3629,11064,3629,15,474
삼산체육관역(호수공원),40539,494,6726,494,6726,0,232
삼산체육관역.상동호수공원,55040,363,3516,354,3516,9,125
삼산체육관역.상동호수공원,55041,242,718,241,718,1,30
삼산체육관역.영상문화단지정문,55044,12821,3942,12814,3942,7,540
삼산타운1단지,40588,4894,7817,4892,7817,2,410
삼산타운1단지정문,40585,3210,1357,3210,1357,0,147
삼산타운1단지후문,40611,1319,788,1319,788,0,67
삼산타운1단지후문,40612,617,861,617,861,0,47
삼산타운4단지,40608,2580,699,2575,699,5,105
삼산타운6단지,40580,2672,2296,2672,2296,0,160
삼산타운7단지,40576,2440,3084,2439,3084,1,178
삼산푸른솔마을,40653,43,2510,43,2510,0,82
삼선1리마을회관,90263,2,6,2,6,0,0
삼선1리마을회관,90280,7,0,7,0,0,0
삼선1리삼거리,90262,0,3,0,3,0,0
삼선1리삼거리,90281,5,1,5,1,0,0
삼선2리마을회관,90265,0,21,0,21,0,0
삼선2리마을회관,90278,14,0,14,0,0,0
삼선2리입구,90264,2,32,2,32,0,1
삼선2리입구,90279,9,0,9,0,0,0
삼성바이오로직스,39863,4,1067,4,1067,0,34
삼성바이오로직스,39864,5107,35,5107,35,0,165
삼성바이오로직스,39920,2061,2397,2061,2397,0,143
삼성빌라(종점),37572,524,883,524,883,0,45
삼성서초역삼세무서,23396,949,1219,949,1219,0,69
삼성아파트,35140,2766,5416,2743,5416,23,263
삼성아파트,38077,5403,5519,5396,5519,7,352
삼성아파트.남인천농협,38125,5843,8199,5832,8199,11,452
삼양감속기,39085,2,6,2,6,0,0
삼양베이커,35131,8,219,8,219,0,7
삼양베이커,35571,95,11,95,11,0,3
삼양사인천1공장,42027,1289,1612,1276,1612,13,93
삼양사인천1공장,42031,2837,4086,2834,4086,3,223
삼영물류,42068,7379,657,7379,657,0,259
삼영아파트,37116,6245,2123,6160,2123,85,269
삼영아파트,37279,10606,11322,10588,11322,18,707
삼영아파트,37280,7811,5227,7787,5227,24,420
삼영아파트,42085,12582,6648,12524,6648,58,620
삼영테크,89055,1770,200,1764,200,6,63
삼영테크,89062,15,1614,15,1614,0,52
삼원페트라,39041,384,4005,384,4005,0,141
삼은교회,37111,5036,1555,5017,1555,19,212
삼익.광명아파트,39247,9781,13295,9774,13295,7,744
삼익.광명아파트,39249,17983,8030,17958,8030,25,839
삼익아파트,35136,2646,6706,2625,6706,21,301
삼익아파트.달동네박물관,36017,9546,11411,9516,11411,30,676
삼일산업,39097,2297,2047,2297,2047,0,140
삼정동중소기업협동화단지,57015,951,1089,951,1089,0,65
삼정동중소기업협동화단지,57040,883,955,883,955,0,59
삼정사거리,57011,600,1099,600,1099,0,54
삼정사거리,57012,900,466,900,466,0,44
삼정초등학교,57008,1135,834,1135,834,0,63
삼정초등학교,57009,520,975,520,975,0,48
삼정프라자,42443,18385,25447,18367,25447,18,1413
삼진금속,39040,2679,343,2678,343,1,97
삼천리1차아파트,41178,3151,2768,3111,2768,40,190
삼천리1차아파트,41179,3177,2515,3126,2515,51,183
삼천리3차아파트,41150,5663,4379,5594,4379,69,323
삼천리3차아파트,41159,5108,5487,5046,5487,62,341
삼천리기계,92017,162,467,162,467,0,20
삼천리기계,92018,263,188,263,188,0,14
삼호제강2공장,39939,151,890,151,890,0,33
삼호제강2공장,39940,748,151,748,151,0,29
삼환1단지아파트,37252,1473,2678,1472,2678,1,133
삼환아파트,38063,1782,2858,1781,2858,1,149
삼환아파트,39296,204,1439,200,1439,4,53
삼환아파트,39299,3486,2232,3478,2232,8,184
삼환아파트,39316,11946,9021,11939,9021,7,676
삼환아파트,39323,961,4076,961,4076,0,162
삼환아파트,39328,8362,7699,8362,7699,0,518
삼환아파트,80058,27,1890,27,1890,0,61
상1리마을회관(창말),90339,0,11,0,11,0,0
상1리마을회관(창말),90342,7,0,6,0,1,0
상2리마을회관,90337,1,17,1,17,0,0
상2리마을회관,90343,32,0,31,0,1,1
상덕현삼거리,43462,10,17,10,17,0,0
상덕현삼거리,43767,6,19,6,19,0,0
상도중학교,55025,1921,123,1918,123,3,65
상도중학교,55028,471,2007,470,2007,1,79
상동가구,55090,1735,1579,1716,1579,19,106
상동역1번출구.부천터미널소풍.홈플러스,55052,7249,21151,7232,21151,17,916
상동역4번출구.상동지하차도,55048,1586,6175,1582,6175,4,250
상동역5번출구.상동지하차도,55050,16235,3295,16172,3295,63,630
상동역8번출구세이브존,55056,10678,5368,10661,5368,17,517
상사마을,25027,51,199,51,199,0,8
상수도사업본부(스마트타운),37375,4507,7796,4498,7796,9,396
상수도사업본부(스마트타운),37380,4740,10161,4727,10161,13,480
상야동,41436,1145,1016,1140,1016,5,69
상야동,41437,987,1435,983,1435,4,78
상용리마을회관,90038,0,27,0,27,0,0
상용리마을회관,90039,40,0,37,0,3,1
상용진료소앞,90004,13,76,11,76,2,2
상용진료소앞,90005,72,6,66,6,6,2
상인천중학교,39537,293,161,289,161,4,14
상인천초등학교,39340,999,476,968,476,31,47
상인천초등학교,39345,441,1122,432,1122,9,50
상정고,40069,13925,3264,13916,3264,9,554
상정고,40070,4395,15596,4387,15596,8,644
상정중학교,40059,4805,7821,4785,7821,20,407
상주(상리),90331,22,7,22,7,0,0
상주민지원센터.삼광교회,55029,1225,4510,1220,4510,5,185
상주민지원센터.삼광교회,55031,5903,585,5885,585,18,209
상촌,43152,32,12,32,12,0,1
상촌,43347,12,43,12,43,0,1
새꾸지마을,90133,15,28,14,28,1,1
새꾸지마을,90134,46,34,45,34,1,2
새마을,43471,0,8,0,8,0,0
새마을,43702,4,1,4,1,0,0
새마을금고,36053,2506,996,2492,996,14,112
새마을금고,36189,321,1643,320,1643,1,63
새마을금고,40125,939,1332,934,1332,5,73
새마을금고,40126,1985,319,1985,319,0,74
새마을금고,40131,990,3748,979,3748,11,152
새마을금고,40746,73,830,73,830,0,29
새말사거리,41009,4114,2325,4114,2325,0,207
새말사거리,41010,169,3522,167,3522,2,119
새말사거리,41012,1435,3211,1418,3211,17,149
새말사거리,41013,3429,2456,3418,2456,11,189
새말사거리,41638,859,1727,857,1727,2,83
새봄초등학교,38679,2501,4756,2486,4756,15,234
새봄초등학교·송도파크레인(후문),38678,5197,1914,5164,1914,33,229
새사미아파트,41582,451,320,451,320,0,24
새소망교회,40850,1961,6,1960,6,1,63
새소망교회,40917,1,366,1,366,0,11
새안의원,37255,10676,12724,10628,12724,48,754
새안의원,37256,17922,8900,17857,8900,65,865
새터마을,35033,26,284,25,284,1,10
새터마을,35362,258,32,256,32,2,9
새한아파트,37046,4951,2338,4923,2338,28,235
색동원 앞,43161,24,7,23,7,1,1
색동원 앞,43215,8,15,8,15,0,0
샘골,90406,0,8,0,8,0,0
샘골,90407,7,0,7,0,0,0
샘말,43444,5,15,5,15,0,0
샘말,43782,39,23,37,23,2,2
샛말,43994,19,15,19,15,0,1
샛말,43995,20,25,20,25,0,1
생산기술연구원,38354,266,918,266,918,0,38
생설미,43746,402,218,383,218,19,20
생설미입구,43125,4,4,4,4,0,0
생설미입구,43607,5,8,5,8,0,0
생설미입구,43608,3,60,3,60,0,2
샬롬원입구,90293,4,11,4,11,0,0
샬롬원입구,90297,1,1,1,1,0,0
서곶지구대,42338,11074,8402,11071,8402,3,628
서곶지구대,42339,11383,8454,11382,8454,1,639
서교동,23037,226,4549,226,4549,0,154
서교동,23038,10713,301,10713,301,0,355
서구국민체육센터,42776,723,3675,723,3675,0,141
서구문화회관,42212,1575,2044,1563,2044,12,116
서구문화회관,42213,3351,893,3315,893,36,136
서구보건소,42283,4552,3987,4545,3987,7,275
서구보건소,42285,3821,4300,3820,4300,1,261
서구영어마을,42448,7665,6009,7650,6009,15,441
서구영어마을,42449,4691,8313,4673,8313,18,419
서구청역(1번출구),42289,4043,3953,4029,3953,14,257
서구청역(3번출구),42284,1277,715,1276,715,1,64
서구청역(4번출구),42296,2037,2393,2032,2393,5,142
서남촌,43151,5,1,5,1,0,0
서남촌,43640,3,5,3,5,0,0
서당골,35676,24,66,24,66,0,2
서당골,35702,94,36,94,36,0,4
서두머리,43212,31,8,31,8,0,1
서두머리,43336,0,19,0,19,0,0
서림초등학교,36036,1,683,1,683,0,22
서림초등학교,36047,12853,1435,12846,1435,7,460
서릿목,35418,168,518,168,518,0,22
서릿목,35419,575,156,573,156,2,23
서면초등학교,38384,1770,1402,1767,1402,3,102
서문안,43385,27,127,27,127,0,4
서문안,43584,199,14,158,14,41,6
서문안주유소,43965,120,11,113,11,7,4
서문안주유소,43966,16,184,16,184,0,6
서부경찰서,42286,551,755,551,755,0,42
서부공단입구,42299,4806,4486,4806,4486,0,299
서부공단입구,42301,5784,1388,5782,1388,2,231
서부산업단지,89035,55,68,55,68,0,3
서부산업단지,89036,40,266,40,266,0,9
서사체험학습장,43487,2,9,2,9,0,0
서사체험학습장,43712,13,9,13,9,0,0
서성,43234,7,87,7,87,0,3
서성,43362,214,5,205,5,9,7
서운교,41114,820,4527,807,4527,13,172
서운교,41115,4290,381,4283,381,7,150
서운도서관,41099,1495,293,1495,293,0,57
서운도서관,41102,200,1898,200,1898,0,67
서운도서관,41668,55,2133,55,2133,0,70
서운동,41356,6993,648,6958,648,35,246
서운동성당,41207,1365,2141,1349,2141,16,113
서운일반산업단지,41660,2368,16,2304,16,64,76
서운일반산업단지(맞은편),41661,68,1600,42,1600,26,53
서운일반산업단지입구,41646,612,3696,612,3696,0,138
서운일반산업단지입구(맞은편),41647,1069,1215,1069,1215,0,73
서운중고등학교,41109,267,686,265,686,2,30
서운중고등학교,41111,755,424,745,424,10,38
서울경금속,39039,204,2913,203,2913,1,100
서울방화초등학교,25028,62,17,62,17,0,2
서울역,11013,17231,12010,17231,12010,0,943
서원아파트,37095,1602,1186,1593,1186,9,89
서인천가구단지,42017,1007,3295,1006,3295,1,138
서인천가구단지,42028,3466,2810,3453,2810,13,202
서인천가구단지,42800,557,97,557,97,0,21
서인천고등학교,42346,4314,4245,4314,4245,0,276
서인천농협,42275,1496,579,1496,579,0,66
서인천농협,42277,252,967,252,967,0,39
서인천세무서,89044,297,52,296,52,1,11
서인천세무서,89481,115,64,115,64,0,5
서인천세무서(중),89275,2051,2644,2051,2644,0,151
서인천세무서(중),89276,1164,2259,1164,2259,0,110
서인천자동차검사소,42640,601,3145,601,3145,0,120
서인천자동차검사소,42641,4304,371,4304,371,0,150
서창119안전센터,39900,10844,3637,10844,3637,0,467
서창119안전센터,39899,5506,9731,5506,9731,0,491
서창LH1단지아파트,92067,5535,365,5535,365,0,190
서창LH1단지아파트,92068,901,4175,901,4175,0,163
서창공영차고지,39871,8354,155,8333,155,21,274
서창공영차고지,39872,1723,5635,1651,5635,72,237
서창도서관,39893,1217,1782,1217,1782,0,96
서창도서관,39894,1723,1121,1723,1121,0,91
서창도서관입구,39956,182,1730,182,1730,0,61
서창도서관입구,39957,2951,754,2943,754,8,119
서창동화원,39619,192,857,191,857,1,33
서창동화원,39620,515,399,514,399,1,29
서창베라체아파트후문,39895,298,129,298,129,0,13
서창베라체아파트후문,39896,32,480,32,480,0,16
서창센트라스아파트후문,39916,6488,804,6487,804,1,235
서창센트라스아파트후문,39917,1302,3979,1298,3979,4,170
서창센트럴푸르지오,39811,3417,297,3411,297,6,119
서창센트럴푸르지오,39812,353,3187,351,3187,2,114
서창센트럴푸르지오,39903,13397,7972,13369,7972,28,689
서창센트럴푸르지오,39904,13472,12269,13472,12269,0,830
서창이편한세상1002동,39905,12837,7710,12810,7710,27,662
서창이편한세상1002동,39906,7492,13309,7490,13309,2,671
서창이편한세상정문,39854,811,13764,809,13764,2,470
서창이편한세상정문,39855,14813,522,14782,522,31,494
서창퍼스트뷰후문,39777,11747,2836,11747,2836,0,470
서창퍼스트뷰후문맞은편,39778,1494,10237,1494,10237,0,378
서창휴먼시아12단지,39897,2358,158,2358,158,0,81
서창휴먼시아12단지,39898,356,1841,356,1841,0,70
서초구청,22129,423,42,423,42,0,15
서초동삼성아파트,22140,11,153,11,153,0,5
서초아트자이아파트,31050,3998,11198,3998,11198,0,490
서초역1번출구,31007,9878,26072,9878,26072,0,1159
서초힐스아파트,22286,696,1396,696,1396,0,67
서한리구마을회관,90294,12,12,12,12,0,0
서한리구마을회관,90296,4,1,4,1,0,0
서한리마을회관,90295,38,40,38,40,0,2
서해5도특별경비단,35098,1492,182,1479,182,13,54
서해5도특별경비단,35884,63,1392,62,1392,1,46
서해그랑블,40828,2267,150,2267,150,0,77
서해그랑블,42789,3290,8460,3289,8460,1,379
서해그랑블,42790,6477,2417,6472,2417,5,286
서해그랑블,42912,3800,842,3786,842,14,149
서해그랑블1단지아파트,38604,1025,40,1021,40,4,34
서해그랑블1단지아파트,38605,39,734,39,734,0,24
서해그랑블3단지아파트,38725,830,52,828,52,2,28
서해그랑블3단지아파트,38726,27,662,26,662,1,22
서해그랑블아파트후문,39973,1895,2213,1889,2213,6,132
서해그랑블아파트후문,39974,2910,2621,2909,2621,1,178
서해그랑블후문,40610,123,1013,123,1013,0,36
서해수산연구소,35007,131,3,125,3,6,4
서해수산연구소,35008,6,218,6,218,0,7
서해아파트,38164,2996,1622,2996,1622,0,148
서해아파트,38169,2289,2286,2289,2286,0,147
서해아파트,41181,1551,2341,1535,2341,16,125
서해아파트,41182,2852,1448,2838,1448,14,138
서해아파트,42354,4337,10102,4336,10102,1,465
서해아파트,42355,16902,4301,16897,4301,5,683
서홍의입구,43446,8,13,8,13,0,0
서홍의입구,43796,41,5,41,5,0,1
서화초등학교(도화e편한세상),37438,13948,7192,13914,7192,34,681
서화초등학교(도화e편한세상),37623,9282,10870,9261,10870,21,650
서흥초등학교,36071,7553,3203,7510,3203,43,346
서흥초등학교,36116,657,398,656,398,1,34
서흥초등학교,36117,210,2324,207,2324,3,81
석건연립,37051,2106,7212,2093,7212,13,300
석남고가교입구사거리,42655,22697,8788,22688,8788,9,1015
석남고가사거리,42145,20485,17630,20386,17630,99,1229
석남고가사거리,42151,28713,20678,28664,20678,49,1593
석남금호어울림아파트101동,42656,4573,9515,4573,9515,0,454
석남도서관,42182,977,2089,974,2089,3,98
석남동차고지,89156,665,4,665,4,0,21
석남서초등학교,42108,5608,3149,5605,3149,3,282
석남신사거리,42149,2165,1682,2139,1682,26,124
석남신사거리,42150,2131,2830,2116,2830,15,160
석남역(5번출구),42577,21867,43507,21849,43507,18,2108
석남중앙교회,42138,3105,1958,3092,1958,13,163
석남중학교,42126,7713,6003,7668,6003,45,442
석남중학교,42128,7053,7352,6951,7352,102,464
석남초등학교,42165,11020,3382,10906,3382,114,464
석남초등학교,42167,3334,8632,3319,8632,15,386
석락아파트,37241,10770,8827,10701,8827,69,632
석락아파트,37244,2069,3876,2055,3876,14,191
석모1리마을회관,90145,34,15,34,15,0,1
석모1리마을회관,90146,14,8,14,8,0,0
석모대교(석모리방향),90137,2,17,2,17,0,0
석모대교(석모리방향),90138,19,12,19,12,0,1
석모대교(석포리방향),90139,23,3,23,3,0,0
석모대교(석포리방향),90140,18,57,18,57,0,2
석모대교(외포리방향),90121,3,51,3,51,0,1
석모대교(외포리방향),90122,13,12,12,12,1,0
석모대교전망대,90249,3,9,3,9,0,0
석모대교전망대,90250,11,6,11,6,0,0
석모도미네랄온천,90163,86,60,86,60,0,4
석모도미네랄온천,90164,8,86,8,86,0,3
석모도수목원입구(삼산초등학교),90143,8,54,7,54,1,2
석모도수목원입구(삼산초등학교),90144,60,48,58,48,2,3
석모도자연휴양림입구,90151,0,4,0,4,0,0
석모도자연휴양림입구,90152,8,3,8,3,0,0
석바위,37365,22722,19312,22647,19312,75,1355
석바위,37370,53503,40920,53372,40920,131,3045
석바위시장,37378,2432,6377,2416,6377,16,284
석바위시장,37381,24196,24969,24138,24969,58,1585
석바위시장,37382,21556,19457,21503,19457,53,1323
석바위시장,37384,5130,3903,5110,3903,20,291
석바위시장,37544,2953,4362,2923,4362,30,235
석바위시장역,37373,4802,5539,4773,5539,29,333
석바위시장역,37374,4096,4653,4074,4653,22,282
석산,43375,2,22,2,22,0,0
석산,43833,21,0,21,0,0,0
석산로,92051,1049,505,1017,505,32,50
석산로,92052,494,562,481,562,13,34
석암초등학교,37412,3962,4216,3931,4216,31,263
석암초등학교앞,37407,14404,8658,14301,8658,103,743
석정여자고등학교,39416,1780,297,1756,297,24,67
석정여자고등학교,39418,114,2057,112,2057,2,70
석조여래입상앞,43663,0,22,0,22,0,0
석조여래입상앞,43692,32,1,29,1,3,1
석천사거리,39308,691,822,675,822,16,48
석천사거리역,39317,3999,7378,3993,7378,6,367
석천사거리역,39320,2870,3100,2859,3100,11,192
석천시장,39502,824,4394,814,4394,10,168
석포리마을회관,90191,26,3,25,3,1,0
석포리마을회관,90192,4,31,4,31,0,1
석포항,90203,18,26,16,26,2,1
선경그린빌라,42307,2292,1774,2279,1774,13,131
선경그린빌라,42541,71,784,71,784,0,27
선경아파트,40238,7507,1980,7507,1980,0,306
선광,38542,0,389,0,389,0,12
선광,38543,261,10,261,10,0,8
선녀바위유원지,35004,589,30,585,30,4,19
선녀바위유원지,35006,112,568,112,568,0,21
선녀바위해수욕장,35484,957,120,957,120,0,34
선녀바위해수욕장,35485,255,773,255,773,0,33
선동,43248,3,16,3,16,0,0
선동,43886,41,2,35,2,6,1
선두1리,43009,247,103,245,103,2,11
선두1리,43099,54,117,52,117,2,5
선두4리마을회관,43242,17,10,17,10,0,0
선두4리마을회관,43644,0,13,0,13,0,0
선두5리어판장입구,90131,10,22,10,22,0,1
선두5리어판장입구,90132,27,5,25,5,2,1
선릉역,23218,2359,8,2359,8,0,76
선릉역,23259,56,4052,56,4052,0,132
선린감리교회,40043,3488,2224,3480,2224,8,184
선린감리교회,40047,4335,5821,4318,5821,17,327
선바위역,66001,19784,693,19784,693,0,660
선바위역,66002,1308,35941,1308,35941,0,1201
선수,43433,7,15,6,15,1,0
선수,43483,28,11,27,11,1,1
선수여객선착장,43429,190,119,174,119,16,9
선수여객선착장,43479,15,42,15,42,0,1
선수촌사거리,39889,162,593,158,593,4,24
선수촌사거리,39890,365,308,358,308,7,21
선원면사무소앞,90067,0,24,0,24,0,0
선원면사무소앞,90068,5,10,5,10,0,0
선원면주민센터,43042,197,469,197,469,0,21
선원면주민센터,43070,451,155,442,155,9,19
선원사,43742,4,9,3,9,1,0
선원사초입,43307,14,8,12,8,2,0
선원사초입,43756,3,5,3,5,0,0
선원초등학교,43044,61,188,61,188,0,8
선원초등학교,43045,251,43,233,43,18,9
선유고등학교,28017,10110,723,10110,723,0,349
선유고등학교,28018,731,11336,731,11336,0,389
선재대교,44085,9,0,9,0,0,0
선재대교,44175,2,4,2,4,0,0
선재대교입구,44005,26,477,23,477,3,16
선재대교입구,44006,555,25,541,25,14,18
선주삼거리,41481,0,15,0,15,0,0
선주지다리,41480,9,39,9,39,0,1
선학동행정복지센터.정광아파트,38297,1323,1205,1321,1205,2,81
선학사거리,38295,1252,4115,1249,4115,3,173
선학아파트,38232,6231,1598,6228,1598,3,252
선학아파트,38343,3266,10067,3252,10067,14,430
선학어린이집,38300,2026,1940,1972,1940,54,127
선학역,38305,33805,15301,33753,15301,52,1584
선학역(1번출구),38306,19816,25787,19737,25787,79,1471
선학중학교,38283,856,932,834,932,22,57
선학체육관(하키경기장),38308,3212,2012,3192,2012,20,168
선학체육관(하키경기장),38309,2367,4559,2350,4559,17,223
선행리입구,43908,34,76,33,76,1,3
선행리입구,43909,35,1,34,1,1,1
설호아파트,43378,19,109,18,109,1,4
설호아파트,43618,96,85,94,85,2,5
성강지식산업센터,39837,595,648,595,648,0,40
성경,43603,106,13,104,13,2,3
성경,43771,22,126,22,126,0,4
성리중학교,39969,46,14,46,14,0,1
성리중학교,39979,0,218,0,218,0,7
성리초등학교,39200,20554,19768,20500,19768,54,1300
성리초등학교,39201,9558,16047,9533,16047,25,825
성문교회,39462,535,5,529,5,6,17
성문아파트,39591,4318,1548,4301,1548,17,189
성문아파트(문화연립),39257,2919,3898,2892,3898,27,219
성민병원,42159,15358,15047,15174,15047,184,980
성민병원,42162,14564,17101,14490,17101,74,1021
성보공업,42007,1837,2249,1830,2249,7,131
성산교회,40572,1627,8082,1608,8082,19,313
성신아크릴산업,89313,152,2,146,2,6,4
성신아크릴산업,89327,12,152,12,152,0,5
성웅아파트,42048,3717,2513,3701,2513,16,200
성웅아파트,42051,3835,2659,3827,2659,8,209
성원기계,92016,1502,1809,1500,1809,2,106
성원빌딩.우편취급국,37425,11309,6186,11296,6186,13,564
성원아파트,70022,2600,12,2596,12,4,84
성일산업,39787,1067,1481,1062,1481,5,82
성일산업,39788,1117,799,1117,799,0,61
성일아파트후문앞,40311,884,542,884,542,0,46
성지아파트,38017,23915,38412,23901,38412,14,2010
성지아파트,41025,5528,3759,5528,3759,0,299
성지초등학교,41033,2231,3860,2195,3860,36,196
성지초등학교,41034,2770,1866,2744,1866,26,149
성터지,43038,222,96,222,96,0,10
성터지,43039,95,174,95,174,0,8
성호아파트,38204,11218,10860,11186,10860,32,712
세광2차아파트,43758,1959,549,1905,549,54,80
세광2차아파트,43857,320,1383,314,1383,6,54
세광아파트,43049,1014,2090,1009,2090,5,100
세광아파트,43050,2581,756,2559,756,22,107
세농푸드,41510,28,1,28,1,0,0
세우산업,39094,1928,4190,1927,4190,1,197
세월천사거리,40489,4769,13217,4743,13217,26,580
세일빌라.인천산림조합,39158,2647,1198,2637,1198,10,124
세일빌라.인천산림조합,39159,4834,3706,4828,3706,6,275
세현정공,39033,868,1848,868,1848,0,87
세화파렛텍,90216,44,38,44,38,0,2
센타빌딩,39902,11563,13077,11559,13077,4,794
센트럴공원,38490,903,3222,902,3222,1,133
센트럴자이,39884,4014,2351,4013,2351,1,205
센트럴파크1,38463,514,175,514,175,0,22
센트럴파크2,38464,218,312,218,312,0,17
센트럴파크역,38397,8551,1098,8551,1098,0,311
센트럴파크역,38574,992,2521,991,2521,1,113
센트럴파크푸르지오아파트,38544,1877,1243,1872,1243,5,100
센트럴파크푸르지오아파트,38545,957,1871,955,1871,2,91
센트럴푸르지오501동앞,92071,1428,413,1427,413,1,59
셀트리온(주),38319,162,495,161,495,1,21
셀트리온(주)앞,38513,429,315,429,315,0,24
셀트리온2공장앞,38474,574,610,574,610,0,38
셀트리온2공장앞,38475,1358,523,1357,523,1,60
소게,43185,2,104,2,104,0,3
소게,43243,82,1,78,1,4,2
소구월사거리,39266,5228,11303,5201,11303,27,533
소구월사거리,39268,4645,3413,4610,3413,35,259
소나무,43396,51,0,48,0,3,1
소나무,43805,1,53,1,53,0,1
소담(장미)마을입구,90236,0,1,0,1,0,0
소담(장미)마을입구,90237,2,2,2,2,0,0
소동,43412,83,0,81,0,2,2
소동,43829,10,172,10,172,0,5
소래도서관,39829,17,477,5,477,12,15
소래산등산로입구,39770,0,17,0,17,0,0
소래산등산로입구,39771,6,4,6,4,0,0
소래산입구,39668,14,317,14,317,0,10
소래산입구,39670,400,8,400,8,0,13
소래역사관,39816,141,1527,135,1527,6,53
소래역사관,39817,2601,152,2578,152,23,88
소래초등학교,39615,258,322,258,322,0,18
소래포구,39815,1079,102,1071,102,8,38
소래포구,39818,97,2651,94,2651,3,88
소래포구 해오름광장,92074,102,1266,100,1266,2,44
소래포구역,39647,3352,1603,3352,1603,0,159
소래포구역,39648,2507,5113,2506,5113,1,245
소래포구역,39710,1916,53,1896,53,20,63
소래포구역앞,92063,2015,1150,2015,1150,0,102
소래포구역종점,39793,509,25,501,25,8,17
소래포구입구,70009,803,170,792,170,11,31
소래포구입구(논현푸르지오A),39109,329,968,320,968,9,41
소래포구입구(논현푸르지오A),39114,284,176,283,176,1,14
소래풍림아파트,39122,2775,822,2768,822,7,116
소리공원(하모니로),38721,555,761,553,761,2,42
소리공원(하모니로),38722,250,448,249,448,1,22
소망탑빌라,40116,9,348,9,348,0,11
소방대앞,90022,11,69,11,69,0,2
소방대앞,90023,137,19,133,19,4,5
소산서원,70011,197,715,194,715,3,29
소산서원,70012,219,381,217,381,2,19
소장전,43996,17,31,17,31,0,1
소장전,43997,10,6,10,6,0,0
소촌마을,41662,214,14,214,14,0,7
속아지,43344,42,0,39,0,3,1
속아지,43848,0,19,0,19,0,0
솔밭마을,38193,936,273,935,273,1,39
솔빛마을,36034,8830,9382,8796,9382,34,587
솔빛마을,36037,5830,6626,5801,6626,29,401
솔빛마을주공아파트,36049,10628,6871,10612,6871,16,564
솔빛마을주공아파트,36050,9597,12103,9592,12103,5,700
솔빛주공2단지,36045,1073,877,1060,877,13,62
솔안공원,38348,11585,6914,11563,6914,22,596
솔정,43526,15,1,10,1,5,0
솔정,43871,5,12,5,12,0,0
솔정1리마을회관,90085,0,3,0,3,0,0
솔정1리마을회관,90086,1,0,1,0,0,0
솔정마을,43129,39,4,30,4,9,1
솔정마을,43811,5,0,4,0,1,0
솔정마을,43872,16,32,10,32,6,1
솔정마을,90108,0,11,0,11,0,0
솔정정미소,43130,20,24,20,24,0,1
솔정정미소,43134,31,5,27,5,4,1
솔터마을입구,80327,1032,346,1032,346,0,44
솔터마을입구,80336,1174,1183,1173,1183,1,76
솔펜션,44143,6,5,6,5,0,0
솔펜션,44177,1,3,1,3,0,0
송곡촌,43439,17,50,17,50,0,2
송곡촌,43815,69,12,67,12,2,2
송내고교입구,11014,71,409,69,409,2,15
송내고교입구,11015,735,158,735,158,0,28
송내고등학교,40219,2377,2665,2353,2665,24,162
송내남부역,40761,33,1175,33,1175,0,38
송내역.로데오거리,55267,5283,26952,5260,26952,23,1039
송내역.영화의거리,55263,23765,6808,23686,6808,79,986
송내역남부,56002,86957,71502,86911,71502,46,5111
송내역남부,56005,100016,80838,99870,80838,146,5834
송담초등학교,38667,2156,764,2156,764,0,94
송담초등학교,38668,767,2095,767,2095,0,92
송도1동행정복지센터,38012,4844,12742,4839,12742,5,567
송도2동행정복지센터,38492,4681,3075,4672,3075,9,250
송도2동행정복지센터,38588,1310,1809,1309,1809,1,100
송도MTB파크,38746,181,249,181,249,0,13
송도SK뷰(101동),38635,1715,511,1715,511,0,71
송도SK뷰(105동),38632,65,577,65,577,0,20
송도SK뷰(105동),38633,987,140,987,140,0,36
송도sk뷰,38707,993,3701,992,3701,1,151
송도sk뷰,38708,686,1455,684,1455,2,69
송도고입구,38215,2835,2396,2835,2396,0,168
송도고입구,38221,2275,1060,2272,1060,3,107
송도공영차고지,38472,421,45,421,45,0,15
송도국제교입구,38597,228,0,228,0,0,7
송도국제도시디에트르시그니처뷰,38771,1634,1350,1633,1350,1,96
송도글로벌캠퍼스푸르지오아파트,38711,773,749,773,749,0,49
송도누리공원,38663,4263,4850,4263,4850,0,293
송도누리공원,38664,1060,3669,1060,3669,0,152
송도달빛축제공원,38776,76,298,76,298,0,12
송도달빛축제공원역,38696,19821,3078,19813,3078,8,738
송도달빛축제공원역,38697,2576,16600,2576,16600,0,618
송도더샵그린스퀘어,39843,3777,1531,3775,1531,2,171
송도더샵그린워크,38526,1165,284,1165,284,0,46
송도더샵그린워크2차,38493,2213,2996,2212,2996,1,168
송도더샵마스터뷰21단지,38578,6220,719,6198,719,22,223
송도더샵마스터뷰22단지,38693,682,330,682,330,0,32
송도더샵마스터뷰22단지(2202동),38698,175,431,175,431,0,19
송도더샵마스터뷰22단지(2202동),38712,356,1060,356,1060,0,45
송도더샵마스터뷰22단지(정문),38694,231,1129,231,1129,0,43
송도더샵마스터뷰22단지(하행),38695,205,580,205,580,0,25
송도더샵마스터뷰23단지,38441,3125,2849,3113,2849,12,192
송도더샵마스터뷰23단지,38442,490,5099,489,5099,1,180
송도더샵마스터뷰23단지(정문),38692,1694,258,1694,258,0,62
송도더샵센트럴시티,39842,2302,3525,2292,3525,10,187
송도더샵센트럴시티.글로벌캠퍼스푸르지오,38647,5538,1146,5538,1146,0,215
송도더샵퍼스트월드,38589,1167,1612,1167,1612,0,89
송도더샵퍼스트월드(동문),38013,17973,6807,17964,6807,9,799
송도더샵퍼스트월드(서문),38381,3801,1583,3798,1583,3,173
송도더샵퍼스트월드B동.C동,38425,3906,2352,3896,2352,10,201
송도더샵퍼스트월드D동,38009,1725,1869,1721,1869,4,115
송도더샵퍼스트파크14단지,38560,525,3680,510,3680,15,135
송도더샵퍼스트파크14단지,38577,2940,339,2925,339,15,105
송도더샵퍼스트파크15단지,38559,217,1003,215,1003,2,39
송도더샵퍼스트파크15단지,38576,1018,209,1008,209,10,39
송도더샵하버뷰2차,38467,2385,12940,2378,12940,7,494
송도동일하이빌파크포레아파트,38680,3105,1042,3084,1042,21,133
송도라마다호텔앞,38065,2495,4831,2488,4831,7,236
송도라마다호텔앞,38067,12312,8631,12280,8631,32,675
송도랜드마크시티13호근린공원,38738,285,1637,285,1637,0,62
송도랜드마크시티13호근린공원,38739,979,441,979,441,0,45
송도랜드마크푸르지오시티,38747,875,1362,873,1362,2,72
송도베르디움더퍼스트후문,39985,1264,4661,1264,4661,0,191
송도세브란스병원,38651,24,622,24,622,0,20
송도센트럴파크,38452,2298,6365,2298,6365,0,279
송도센트럴파크역,38563,2139,975,2127,975,12,100
송도소방서(송도스마트밸리),39801,1798,2671,1798,2671,0,144
송도스마트밸리,39802,4103,1584,4103,1584,0,183
송도스포츠센터(LNG야구장),39721,1237,811,1237,811,0,66
송도아트윈푸르지오,38549,600,532,591,532,9,36
송도아트윈푸르지오,38562,2,333,2,333,0,10
송도에듀포레푸르지오,39921,1414,2899,1414,2899,0,139
송도에듀포레푸르지오후문,39986,5188,817,5188,817,0,193
송도역,38213,2636,2014,2634,2014,2,150
송도역,38505,8537,16412,8523,16412,14,804
송도역,38669,890,1467,890,1467,0,76
송도영남아파트,38224,8612,6933,8584,6933,28,501
송도오션파크베르디움,38642,1281,17371,1278,17371,3,601
송도요양원,38144,1676,2634,1676,2634,0,139
송도유원지(도로교통공단),38081,11639,13486,11599,13486,40,810
송도유원지(도로교통공단),38088,20108,8176,19997,8176,111,912
송도자이하버뷰,38521,2958,1757,2958,1757,0,152
송도자이하버뷰1단지,38468,17069,2322,17060,2322,9,625
송도자이하버뷰2단지(202동),38488,1673,2940,1655,2940,18,148
송도자이하버뷰2단지(205동),38455,538,433,538,433,0,31
송도자이하버뷰2단지(정문),38465,2532,1741,2522,1741,10,137
송도자이하버뷰2단지(정문),38498,1793,1773,1791,1773,2,115
송도재래시장,38207,6313,7305,6301,7305,12,439
송도재래시장,38210,8549,8046,8539,8046,10,535
송도재래시장,38220,6318,2476,6304,2476,14,283
송도제2차고지,38703,443,18,417,18,26,14
송도제2차고지입구,38735,217,506,214,506,3,23
송도중학교,35155,11659,12848,11598,12848,61,790
송도지웰푸르지오시티,38424,6286,10884,6280,10884,6,553
송도채석장,38175,767,2300,767,2300,0,98
송도체육센터,38699,130,615,130,615,0,24
송도체육센터,38700,681,170,681,170,0,27
송도컨벤시아,38367,2154,7581,2150,7581,4,314
송도컨벤시아,38369,2878,1521,2865,1521,13,141
송도컨벤시아남문,38660,2472,1297,2472,1297,0,121
송도컨벤시아남문,38661,1150,2274,1150,2274,0,110
송도타임스페이스,38720,1918,4772,1913,4772,5,215
송도테크노파크IT센터,38752,27,1112,27,1112,0,36
송도테크노파크IT센터,39929,4075,2657,4075,2657,0,217
송도파크레인동일하이빌,38625,12,59,12,59,0,2
송도파크레인동일하이빌,38626,666,1,666,1,0,21
송도파크레인입구,38538,509,3030,509,3030,0,114
송도파크레인입구,38539,1254,1273,1254,1273,0,81
송도파크자이,38627,682,575,679,575,3,40
송도파크자이,38628,25,588,25,588,0,19
송도파크자이아파트,38638,9570,8647,9537,8647,33,587
송도파크자이아파트정문,38677,1034,5160,1024,5160,10,199
송도푸르지오월드마크,38426,5517,6828,5509,6828,8,398
송도푸르지오하버뷰,38494,3297,4335,3288,4335,9,246
송도풍림아이원1단지,38033,3115,25346,3090,25346,25,918
송도풍림아이원2단지,38025,10111,15767,10074,15767,37,834
송도풍림아이원2단지,38026,10007,5364,9991,5364,16,495
송도풍림아이원2단지,38034,26358,3009,26313,3009,45,947
송도풍림아이원4단지,38032,3868,9273,3853,9273,15,423
송도힐스테이트,38479,16002,6339,15992,6339,10,720
송도힐스테이트5단지,38393,5895,6904,5895,6904,0,412
송도힐스테이트6단지,38554,24,77,24,77,0,3
송동마을.서초힐스아파트,22962,1239,109,1239,109,0,43
송림119안전센터,36165,65,266,65,266,0,10
송림3.5동행정복지센터(재능대),36030,2005,6420,2002,6420,3,271
송림4동행정복지센터,36127,2031,1855,2029,1855,2,125
송림고가교,37491,2300,1243,2299,1243,1,114
송림고가교,37492,1282,2360,1281,2360,1,117
송림고개(도화신동아아파트),37439,8715,8577,8688,8577,27,557
송림고개(도화신동아아파트),37501,10715,7261,10673,7261,42,579
송림동진로아파트,36154,300,330,300,330,0,20
송림동진로아파트,36155,98,774,97,774,1,28
송림빌라,43316,26,0,26,0,0,0
송림빌라,43775,4,20,4,20,0,0
송림시장,36015,216,377,216,377,0,19
송림오거리,36131,13735,4030,13720,4030,15,573
송림오거리,36132,3770,9169,3763,9169,7,417
송림주유소,36090,611,486,605,486,6,35
송림체육관,36130,523,80,523,80,0,19
송림체육관,36148,35,336,34,336,1,11
송림체육관후문,36152,341,725,341,725,0,34
송림체육관후문,36153,713,402,708,402,5,35
송림휴먼시아,36124,11,685,11,685,0,22
송림휴먼시아,36125,40,1499,40,1499,0,49
송마3리,80157,980,18,977,18,3,32
송마3리,80158,51,434,49,434,2,15
송마리입구,80159,63,734,61,734,2,25
송마리입구,80160,422,207,422,207,0,20
송명초등학교,92013,3835,324,3835,324,0,134
송산,43482,59,17,58,17,1,2
송산,43710,27,70,27,70,0,3
송산교회,43956,21,23,20,23,1,1
송산삼거리,43480,30,2,27,2,3,1
송산삼거리,43611,0,36,0,36,0,1
송암박두성생가입구,90396,1,13,1,13,0,0
송암박두성생가입구,90397,11,0,11,0,0,0
송월동동화마을,35189,6214,3276,6169,3276,45,306
송월동동화마을,35190,2816,8088,2815,8088,1,351
송월아파트,35193,2815,593,2791,593,24,109
송월아파트,35194,917,3110,914,3110,3,129
송정역,25184,48,3852,47,3852,1,125
송정역,25185,5619,71,5614,71,5,183
송학둥지아파트,38584,3272,3486,3247,3486,25,218
송학둥지아파트,38585,2052,3196,2046,3196,6,169
송해교회,43384,289,83,283,83,6,12
송해교회,43769,66,389,66,389,0,14
송해면사무소,43708,27,90,27,90,0,3
송해면사무소,43809,61,34,60,34,1,3
송해삼거리,43386,312,54,299,54,13,11
송해삼거리,43819,72,354,71,354,1,13
송해초등학교,43807,15,139,15,139,0,4
송해초등학교,43820,105,17,104,17,1,3
송현시장.수도국산달동네박물관,36019,7574,5657,7522,5657,52,426
송현시장.수도국산달동네박물관,36020,6153,22405,6120,22405,33,921
송현시장.수도국산달동네박물관,36025,47,569,44,569,3,19
송현아파트,36065,5737,3521,5720,3521,17,298
송현아파트,36067,2044,4230,2038,4230,6,202
송현주공아파트,36073,822,2713,822,2713,0,114
송현주공아파트,36080,10653,5666,10633,5666,20,526
송현주공아파트후문,36162,660,3074,659,3074,1,120
쇠골큰말,89318,77,46,77,46,0,3
쇠골큰말,89321,92,25,80,25,12,3
수곡(월곳리),43191,36,0,36,0,0,1
수곡(월곳리),43620,0,31,0,31,0,1
수광티티아이,90215,31,31,30,31,1,2
수도군수지원단(장애인복지관),40825,5773,1505,5746,1505,27,234
수도군수지원단(장애인복지관),40826,20,1717,13,1717,7,56
수림공원,39347,1753,786,1753,786,0,81
수림공원,39351,633,1709,633,1709,0,75
수변로삼거리,40367,1022,519,1022,519,0,49
수변로삼거리,40370,2756,5167,2753,5167,3,255
수봉공원,37289,1610,1478,1610,1478,0,99
수봉공원,37569,1213,3136,1213,3136,0,140
수봉공원.인천수봉문화회관입구,37362,12648,6647,12581,6647,67,622
수봉공원.인천수봉문화회관입구,37369,8749,13568,8704,13568,45,719
수봉마을쉼터,37570,2964,3574,2964,3574,0,210
수봉마을쉼터,37571,2837,1979,2837,1979,0,155
수부촌,43041,132,189,132,189,0,10
수산동,39175,260,710,260,710,0,31
수산동,39176,275,395,275,395,0,21
수양관,43245,23,43,23,43,0,2
수양관,43645,102,35,99,35,3,4
수인곡물시장,35134,2483,2466,2451,2466,32,159
수정제입구,90290,4,6,4,6,0,0
수촌,43111,92,0,92,0,0,2
수촌,43358,0,73,0,73,0,2
수출산업단지6공단입구,40009,3692,4787,3683,4787,9,273
수출산업단지6공단입구,40010,2208,2253,2203,2253,5,143
수행마을.홈플러스,80074,789,40,789,40,0,26
수행마을.홈플러스,80075,77,602,77,602,0,21
수현마을,39487,2383,3020,2347,3020,36,174
수현마을,39488,4713,4660,4676,4660,37,302
수협,43060,171,1017,169,1017,2,38
수협,43062,3422,8849,3375,8849,47,395
수협(인천해양센터),35080,2632,87,2603,87,29,87
수협(인천해양센터),35081,77,3586,76,3586,1,118
수협온수지점,90411,1184,465,1178,465,6,53
수협온수지점,90413,326,1297,324,1297,2,52
순복음교회,37253,8786,28102,8737,28102,49,1189
순복음교회,39181,19198,8534,19066,8534,132,894
순복음교회,40661,13629,7353,13625,7353,4,676
순천향대학병원.부명고,55037,8330,1133,8297,1133,33,305
숭덕여중고입구,39461,11505,24308,11461,24308,44,1155
숭덕여중고입구,39463,15670,12336,15613,12336,57,903
숭덕여중고입구,39466,6416,1012,6325,1012,91,239
숭뢰2리,43421,77,238,64,238,13,10
숭뢰2리,43704,199,25,190,25,9,7
숭보사입구,40851,131,21,131,21,0,4
숭보사입구,40918,1,46,1,46,0,1
숭의1.3동(극동아파트),37328,587,579,578,579,9,37
숭의1.3동(극동아파트),37337,512,840,509,840,3,43
숭의2동행정복지센터,37563,1599,2180,1599,2180,0,121
숭의교회,37269,18428,10633,18381,10633,47,937
숭의교회,37271,12713,15430,12683,15430,30,907
숭의로터리,37265,6172,19252,6146,19252,26,820
숭의로터리,37266,15764,5960,15725,5960,39,700
숭의로터리,37273,18439,8733,18388,8733,51,876
숭의로터리.도원체육관,37276,8169,12557,8144,12557,25,668
숭의목공예마을앞,37313,8535,8480,8438,8480,97,548
숭의목공예마을앞,37315,6479,7123,6440,7123,39,438
숭의박문아파트,37353,1512,2735,1506,2735,6,137
숭의박문아파트,37354,2729,1410,2716,1410,13,133
숭의보건지소,37532,14322,4067,14304,4067,18,593
숭의역(1번출구),37510,45324,21941,45250,21941,74,2169
숭의역(2번출구),37211,26892,33179,26854,33179,38,1937
숭의역(3번출구),35133,1046,3806,1043,3806,3,156
숭의역(4번출구),35135,3557,2427,3557,2427,0,193
숭의초등학교,37296,1173,658,1158,658,15,59
숭의초등학교,37308,1126,3477,1126,3477,0,148
숭의초등학교입구,37287,1591,1544,1588,1544,3,101
숲속마을,39649,6055,3757,6052,3757,3,316
숲속마을,39722,1385,4153,1383,4153,2,178
쉐보레인천서비스,40433,1572,4334,1570,4334,2,190
쉐보레출고사무소,89160,1986,39,1971,39,15,65
쉴낙원인천장례식장,41458,1276,2346,1276,2346,0,116
스카이시티자이.화성파크드림,35650,2616,6289,2609,6289,7,287
스타파이브입구,35428,205,36,205,36,0,7
스타파이브입구,35429,19,213,19,213,0,7
스태츠칩팩코리아,35641,18,563,18,563,0,18
스태츠칩팩코리아,35642,400,3,399,3,1,13
스틸랜드,70228,144,412,141,412,3,17
스틸랜드,70229,346,160,335,160,11,16
스포월드골프연습장,42439,100,172,100,172,0,8
스포월드골프연습장,42440,13,130,11,130,2,4
승기천,39169,984,6130,975,6130,9,229
승기천,39170,447,4558,444,4558,3,161
시대아파트,38340,14965,12108,14947,12108,18,873
시리미,43330,31,58,26,58,5,2
시리미,43631,20,0,20,0,0,0
시립가좌테니스장,37581,255,1352,255,1352,0,51
시립가좌테니스장,37582,181,2548,181,2548,0,88
시민공원,37359,13633,5469,13578,5469,55,616
시민공원(문화창작지대)역,37344,23401,22469,23345,22469,56,1479
시민공원(문화창작지대)역,37346,33268,28917,33176,28917,92,2005
시민공원.문화창작지대,37334,16916,33198,16857,33198,59,1616
시민공원.문화창작지대,37468,1613,1393,1610,1393,3,96
시민의숲.양재꽃시장,31002,12851,3702,12851,3702,0,533
시민의숲.양재꽃시장,31003,1539,4429,1539,4429,0,192
시장로터리(중앙철재),40261,2435,2035,2420,2035,15,144
시청광장입구,39217,17042,22457,16952,22457,90,1274
시청광장입구,39218,22499,18199,22451,18199,48,1312
시흥대야역.영남아파트,70027,453,1746,453,1746,0,70
시흥대야역.영남아파트,70028,1984,854,1971,854,13,91
시흥보건소,70015,1879,550,1868,550,11,78
시흥보건소,70016,485,1769,481,1769,4,72
시흥영업소,25846,140,122,140,122,0,8
시흥영업소,25847,74,107,74,107,0,5
신골입구,43998,9,29,8,29,1,1
신골입구,43999,39,16,35,16,4,1
신광주유소,43470,9,0,9,0,0,0
신광주유소,43524,5,9,5,9,0,0
신광초등학교,35142,333,509,333,509,0,27
신기.남부종합시장(진흥사거리),37217,49708,30163,49556,30163,152,2576
신기.남부종합시장(진흥사거리),37219,16116,30561,16055,30561,61,1505
신기사거리,37275,12722,14639,12664,14639,58,882
신김포농협대곶지점,80147,60,30,60,30,0,2
신김포농협대곶지점,80148,149,226,148,226,1,12
신논현역,32055,10773,84,10773,84,0,350
신논현역.우신빌딩,31057,93,6017,93,6017,0,197
신당리동촌부락,90090,20,0,19,0,1,0
신당리동촌부락,90091,0,2,0,2,0,0
신당리마을회관,90088,1,0,1,0,0,0
신당촌,90114,6,1,6,1,0,0
신대진중앙아파트,41271,3833,3071,3830,3071,3,222
신대진중앙아파트,41274,2157,3601,2156,3601,1,185
신도실업(주),40625,593,1672,593,1672,0,73
신동마을,90253,0,7,0,7,0,0
신동마을,90254,9,0,5,0,4,0
신동아1.2차아파트,37507,9039,5898,9018,5898,21,481
신동아1단지,70038,105,202,101,202,4,9
신동아1단지.한일아파트,70037,245,99,243,99,2,11
신동아3차아파트,37119,11334,16549,11325,16549,9,899
신동아3차아파트,37120,11306,17263,11304,17263,2,921
신동아3차아파트,37494,9710,5964,9675,5964,35,505
신동아상가,40860,5340,3569,5340,3569,0,287
신동아상가(백운역방면),40068,5406,8305,5404,8305,2,442
신동아아파트,37072,16,930,15,930,1,30
신동아아파트,37143,8549,13923,8525,13923,24,724
신동아아파트,37160,5591,7750,5589,7750,2,430
신동아아파트,37525,1984,7367,1971,7367,13,301
신동아아파트,39381,2827,6585,2826,6585,1,303
신동아아파트,39382,17062,6322,17029,6322,33,754
신동아아파트,41349,6698,1065,6687,1065,11,250
신동아아파트,41350,1564,5917,1563,5917,1,241
신동아아파트(B),37162,11526,10180,11503,10180,23,700
신동아아파트116동,40060,3634,11787,3633,11787,1,497
신동아아파트116동,40859,7756,2749,7756,2749,0,338
신동아아파트3차,37090,9797,1027,9787,1027,10,349
신동아아파트3차,37097,3332,9257,3326,9257,6,406
신동아아파트4차,37121,5067,1634,5055,1634,12,216
신동아아파트4차,37123,2485,3537,2483,3537,2,194
신동아아파트5차,37141,13103,3919,13079,3919,24,549
신동아아파트8차,37135,1375,3378,1371,3378,4,153
신동아아파트8차,37136,4655,887,4647,887,8,178
신동양아파트,41202,3562,9696,3560,9696,2,427
신동양아파트,41203,8137,4120,8137,4120,0,395
신라아파트,37277,6691,6380,6666,6380,25,421
신라아파트,37543,1830,3901,1823,3901,7,184
신명보람마을.삼부한신아파트,40511,2440,2696,2432,2696,8,165
신명보람마을.삼부한신아파트,40512,585,991,577,991,8,50
신명스카이뷰,35453,1577,3066,1577,3066,0,149
신명스카이뷰,35456,9076,4728,9075,4728,1,445
신명스카이뷰,42737,67,246,66,246,1,10
신명스카이뷰정문,35455,5668,9022,5664,9022,4,473
신명아파트,42081,8203,11809,8152,11809,51,645
신명아파트.대우3차아파트,70018,341,2990,341,2990,0,107
신명아파트앞,42799,11,860,11,860,0,28
신반포역.세화여중고,31033,735,43,735,43,0,25
신봉삼거리,43126,69,1,68,1,1,2
신봉삼거리,43127,4,13,4,13,0,0
신봉삼거리,43463,402,250,389,250,13,21
신봉삼거리,43814,9,12,9,12,0,0
신봉이발관,43458,31,2,31,2,0,1
신봉이발관,43786,0,43,0,43,0,1
신북항고가교,42104,2412,2488,2391,2488,21,158
신북항고가교,42109,1615,2913,1606,2913,9,146
신분당선.강남역4번출구,23572,8973,3487,8973,3487,0,401
신비마을아파트,37164,356,1663,346,1663,10,65
신비마을아파트,37223,4616,7746,4604,7746,12,398
신비마을아파트,37225,6617,4033,6572,4033,45,343
신비마을아파트,37555,230,967,230,967,0,38
신비마을아파트(112동),37171,4718,3285,4685,3285,33,258
신삼1리마을회관,43405,111,3,105,3,6,3
신삼1리마을회관,43791,3,111,3,111,0,3
신삼2리마을회관,43400,141,1,136,1,5,4
신삼2리마을회관,43825,4,91,4,91,0,3
신삼리입구,43606,5,1,5,1,0,0
신삼리입구,43801,1,25,1,25,0,0
신선지입구,90346,7,2,7,2,0,0
신선지입구,90347,1,31,1,31,0,1
신선초등학교,35086,5671,9811,5663,9811,8,499
신선초등학교,35089,10080,3725,10058,3725,22,445
신선초등학교앞,37055,2894,916,2867,916,27,122
신설동,35413,8,40,8,40,0,1
신설동,35416,53,9,53,9,0,2
신설동(3거리),35018,113,3,107,3,6,3
신설동(3거리),35019,9,125,7,125,2,4
신성미소지움,40099,2626,31,2573,31,53,85
신성미소지움,40102,29,1881,18,1881,11,61
신성미소지움,40643,2041,14710,2035,14710,6,540
신성미소지움,40649,7324,2205,7316,2205,8,307
신성미소지움후문,40660,5,515,5,515,0,16
신성성결교회(올림피아병원),39355,13962,9183,13945,9183,17,746
신세계아파트,39383,3369,5106,3353,5106,16,273
신송고등학교,38023,1486,3755,1480,3755,6,169
신송고등학교,38024,3821,2491,3805,2491,16,203
신안실크밸리,35220,945,347,945,347,0,41
신연수역(1번출구),38263,4329,3898,4316,3898,13,265
신연수역(2번출구),38231,2826,584,2826,584,0,110
신연수역(3번출구),38228,6316,4448,6278,4448,38,347
신영자동차,40561,3173,762,3163,762,10,126
신영자동차(종점),40556,5294,2252,5217,2252,77,243
신왕마을,43203,221,4,219,4,2,7
신왕마을,43718,9,158,9,158,0,5
신원기술,39130,20,15,20,15,0,1
신원아침도시오피스텔(홈플러스),39836,5847,7496,5838,7496,9,430
신일교회,39529,4780,7168,4763,7168,17,385
신일아파트,35097,55,32,55,32,0,2
신정1리마을회관,43300,11,7,11,7,0,0
신정1리마을회관,43737,24,15,24,15,0,1
신정삼거리,90111,0,11,0,11,0,0
신정삼거리,90112,9,0,9,0,0,0
신정중학교,38459,2289,1726,2289,1726,0,129
신정중학교,38555,2864,1944,2864,1944,0,155
신중동역4번출구.롯데백화점,55226,1123,4426,1123,4426,0,179
신중동역5번출구.중흥중학교,55071,468,4517,468,4517,0,160
신중동역6번출구.중흥중학교,55072,2689,355,2689,355,0,98
신지동마을회관,43303,54,44,54,44,0,3
신지동마을회관,43740,96,30,93,30,3,4
신진아파트,41107,24732,14655,24713,14655,19,1270
신창아파트,37010,3477,6254,3477,6254,0,313
신창아파트,37464,5313,2461,5303,2461,10,250
신천동,70048,5845,553,5788,553,57,206
신천동,70049,327,6230,323,6230,4,211
신천삼거리,70013,6508,441,6476,441,32,224
신천삼거리,70014,430,6663,428,6663,2,228
신천역.문화의거리,25364,1715,388,1715,388,0,67
신천역.문화의거리,70174,317,1894,317,1894,0,71
신천연합병원,70175,87,701,87,701,0,25
신천연합병원,70231,810,279,810,279,0,35
신촌,43146,20,1,19,1,1,0
신촌,43432,12,8,12,8,0,0
신촌,43459,283,7,271,7,12,9
신촌,43510,0,13,0,13,0,0
신촌,43753,21,197,21,197,0,7
신촌,43800,66,73,66,73,0,4
신촌마을입구,90201,37,9,32,9,5,1
신촌마을입구,90202,3,7,3,7,0,0
신촌역2호선,22052,3702,91,3702,91,0,122
신촌오거리.2호선신촌역,22014,5000,69,5000,69,0,163
신촌오거리.2호선신촌역,23035,144,2693,144,2693,0,91
신촌오거리.현대백화점,22013,10460,167,10460,167,0,342
신촌오거리.현대백화점,23034,447,13228,447,13228,0,441
신촌초등학교,40098,311,881,311,881,0,38
신태양아파트,37406,5155,7526,5151,7526,4,409
신태양아파트,37408,8851,3434,8850,3434,1,396
신트리공원,40472,2283,2475,2283,2475,0,153
신트리공원,40496,2648,4248,2637,4248,11,222
신트리공원,40501,2123,1498,2115,1498,8,116
신포동행정복지센터,35153,3589,2385,3564,2385,25,192
신포동행정복지센터,35154,2102,3497,2086,3497,16,180
신포사거리,35791,48,329,48,329,0,12
신포시장,35160,31097,52886,30953,52886,144,2709
신포시장,35254,54662,32462,54531,32462,131,2810
신포역·인천세관역사공원,35792,372,167,372,167,0,17
신포역·인천세관역사공원,35796,11,14,11,14,0,0
신포역·인천여자상업고등학교,35149,1659,6988,1640,6988,19,278
신포역·인천여자상업고등학교,35150,6960,2535,6956,2535,4,306
신포입구,43491,28,18,27,18,1,1
신포입구,43842,9,19,6,19,3,0
신한빌딩,39901,11003,9761,10993,9761,10,669
신한에이엠,89147,702,19,700,19,2,23
신한일전기,39034,1802,966,1802,966,0,89
신현119안전센터,42596,8955,13210,8914,13210,41,715
신현119안전센터,42600,7718,8211,7685,8211,33,513
신현노인회관,43279,50,6,47,6,3,1
신현노인회관,43527,16,40,15,40,1,1
신현리입구,90062,23,60,23,60,0,2
신현북초등학교,42208,4059,201,4056,201,3,137
신현북초등학교,42209,239,3100,237,3100,2,107
신현북초등학교,42210,1849,273,1839,273,10,68
신현북초등학교,42211,90,1857,88,1857,2,62
신현쇼핑,42217,33682,25800,33419,25800,263,1918
신현쇼핑,42220,41980,25154,41871,25154,109,2165
신현여자중학교후문,42214,3098,3846,3088,3846,10,224
신현여자중학교후문,42680,3191,1895,3190,1895,1,164
신현중학교,42205,86,3572,83,3572,3,118
신현초등학교,42178,1661,1792,1655,1792,6,111
신현초등학교,42179,1861,3267,1853,3267,8,165
신화빌라,42626,492,415,490,415,2,29
신화슈퍼,89314,143,2,136,2,7,4
신화슈퍼,89326,4,148,4,148,0,4
신흥교통,35501,207,10,203,10,4,7
신흥교통입구,35841,1298,24,1280,24,18,42
신흥동주민자치센터,35789,210,104,210,104,0,10
신흥동주민자치센터,35799,27,30,27,30,0,1
신흥시장,35145,11603,14855,11568,14855,35,853
신흥시장,35146,15356,8646,15313,8646,43,774
신흥시장,57002,2724,1353,2724,1353,0,131
신흥시장,57004,1734,2812,1734,2812,0,146
신흥시장후문,35812,83,54,83,54,0,4
신흥시장후문,35813,102,116,102,116,0,7
신흥주민지원센터,57013,3292,1868,3292,1868,0,166
신흥주민지원센터,57014,1785,2909,1785,2909,0,151
신흥초등학교,35156,7418,10137,7354,10137,64,566
실내게이트볼장(신현중학교),42204,4706,94,4685,94,21,154
실미도조개구이,35299,1,17,1,17,0,0
실미삼거리,35740,360,38,355,38,5,12
실미삼거리,35741,34,238,32,238,2,8
심곡극동아파트,42272,1658,300,1647,300,11,63
심곡극동아파트,42273,208,1083,208,1083,0,41
심곡도서관,42946,1967,1418,1958,1418,9,109
심곡도서관,89223,507,2131,505,2131,2,85
심곡동광명아파트,89153,6389,2404,6360,2404,29,283
심곡동광명아파트,89154,2483,4142,2476,4142,7,213
심곡천(심곡3교),89381,113,9,113,9,0,3
심곡천(심곡3교),89382,24,254,24,254,0,8
심곡천봉수교,42875,940,643,940,643,0,51
심곡천봉수교,42951,1643,4805,1642,4805,1,208
심곡초등학교(국제성모병원),42288,3948,4939,3916,4939,32,286
심곡초등학교(국제성모병원),42290,5424,4172,5418,4172,6,309
십리포제2주차장,44110,14,27,14,27,0,1
십리포제2주차장,44207,5,0,5,0,0,0
십리포해수욕장,44088,28,38,28,38,0,2
십리포해수욕장,44208,7,2,7,2,0,0
십정1동행정복지센터,40049,17793,13743,17731,13743,62,1017
십정2동행정복지센터,40056,5209,5961,5193,5961,16,360
십정동차고지,40913,3045,305,3037,305,8,108
십정사거리,40029,6304,5278,6294,5278,10,373
십정사거리,40033,3267,3676,3264,3676,3,223
십정시장입구,40007,20,3600,20,3600,0,116
십정시장입구,40008,3618,33,3618,33,0,117
십정초등학교(동암의원),40041,1403,1355,1359,1355,44,88
십정초등학교(동암의원),40042,768,2434,755,2434,13,103
십정초등학교·더샵부평정문,40045,17672,20901,17612,20901,60,1244
십정초등학교·더샵부평정문,40048,27675,19146,27618,19146,57,1510
쌍마아파트,42112,5891,3323,5868,3323,23,297
쌍마아파트,42114,610,2447,606,2447,4,98
쌍용아파트,37179,5361,2473,5328,2473,33,252
쌍용아파트,37186,1826,4151,1818,4151,8,192
쌍용아파트,37210,762,494,761,494,1,40
쌍용아파트,37228,20132,11713,20055,11713,77,1027
쌍용아파트,37476,13901,22399,13842,22399,59,1170
쌍용아파트,38178,2008,742,2005,742,3,88
쌍용아파트,38184,675,1776,674,1776,1,79
쌍용아파트,38469,4595,2815,4560,2815,35,239
쌍용아파트,41434,1334,4586,1334,4586,0,190
쌍용아파트정문,40439,2699,3628,2660,3628,39,204
쌍용자동차인천정비사업소,36144,103,1052,102,1052,1,37
쑥골고가교,37371,3011,2834,2984,2834,27,188
쑥골고가교,37372,5039,8104,5027,8104,12,423
쑥밭다리,43650,7,3,7,3,0,0
쑥밭다리,43683,16,9,16,9,0,0
아나지고개,41001,2572,2871,2564,2871,8,175
아나지고개,41002,4078,6167,4077,6167,1,330
아동보호센터,35680,77,305,75,305,2,12
아동보호센터,35698,64,59,61,59,3,3
아라노을공원·한신더휴,89404,10368,8775,10364,8775,4,617
아라노을공원·한신더휴,89405,9047,9447,9014,9447,33,596
아라동행정복지센터,42465,13316,17644,13297,17644,19,998
아라동행정복지센터,42467,13270,8048,13261,8048,9,687
아라동행정복지센터(서부고용센터),89401,2780,955,2780,955,0,120
아라동행정복지센터(서부고용센터),89402,1119,4056,1119,4056,0,166
아라뱃길물류센터,89145,1,348,1,348,0,11
아라센트럴파크,89406,2754,3876,2731,3876,23,213
아라센트럴파크,89407,4901,3823,4876,3823,25,281
아름어린이공원,40337,269,606,269,606,0,28
아름어린이공원,40339,884,558,882,558,2,46
아리마을쉼터,37551,17,1251,17,1251,0,40
아리마을쉼터,37552,1591,225,1576,225,15,58
아모텍,39139,1587,2482,1582,2482,5,131
아시아드경기장(공촌사거리)역,42319,2216,4014,2210,4014,6,200
아시아드경기장(공촌사거리)역,42320,506,1385,499,1385,7,61
아시아드대광로제비앙아파트,89257,842,3254,842,3254,0,132
아시아드대광로제비앙아파트,89258,4411,1436,4411,1436,0,188
아암3교사거리,38727,69,332,69,332,0,12
아암3교사거리,38728,125,151,125,151,0,8
아암물류단지,35285,125,0,121,0,4,4
아암물류단지,35590,2,183,0,183,2,5
아울렛(CGV부평),40818,3777,2133,3763,2133,14,190
아이즈빌(부평CGV),40595,12495,8448,12463,8448,32,675
아이즈빌(부평CGV),40598,9390,12965,9361,12965,29,721
아인스월드,55086,661,1373,660,1373,1,65
아주아파트,38047,1540,709,1523,709,17,72
아주아파트,38051,859,1600,846,1600,13,79
아주아파트,38301,1497,888,1494,888,3,76
아주아파트,38304,2088,1509,2078,1509,10,116
아주아파트.미추홀학교,39481,42015,17173,41828,17173,187,1909
아주아파트.미추홀학교,39482,20115,25891,20092,25891,23,1484
아주아파트410동,41575,505,5,505,5,0,16
아침가리마을회관,43287,156,2,151,2,5,5
아침가리마을회관,43867,0,85,0,85,0,2
아쿠아글로리,42811,105,1,105,1,0,3
아트센터인천,38617,28,58,28,58,0,2
아트센터인천,38618,35,103,35,103,0,4
아현역,22062,2957,33,2957,33,0,96
아현역,23078,13,1769,13,1769,0,57
안골마을입구,38225,7653,8508,7637,8508,16,521
안남고(동보1차아파트),41048,773,809,762,809,11,51
안남고등학교,41045,3506,788,3501,788,5,138
안동포교회,42700,483,97,483,97,0,18
안동포교회,42701,36,652,36,652,0,22
안동포사거리,42707,19,139,19,139,0,5
안동포사거리입구,42765,398,17,398,17,0,13
안동포사거리입구,42766,11,1027,6,1027,5,33
안산마을,43132,37,0,35,0,2,1
안산마을,43138,1,58,1,58,0,1
안산초등학교(구계산고교),41425,15324,12785,15287,12785,37,906
안양대학교,43177,470,372,467,372,3,27
안양대학교,43301,652,275,644,275,8,29
안풍산업삼거리,89312,109,3,106,3,3,3
안풍산업삼거리,89329,3,79,3,79,0,2
알앤디써비스,38477,122,1188,122,1188,0,42
알앤디써비스,38478,742,194,741,194,1,30
애관극장,35804,21,100,21,100,0,3
애보박물관,39667,1,18,1,18,0,0
애보박물관,39671,2,20,2,20,0,0
애전마을,43682,13,9,13,9,0,0
애전마을,43894,19,8,19,8,0,0
애전부락,90075,42,74,42,74,0,3
애전부락,90076,56,68,56,68,0,4
앰코코리아(블루오션골프클럽),39880,754,37,754,37,0,25
야곡,43236,40,3,40,3,0,1
야곡,43292,7,71,6,71,1,2
야촌,43210,12,0,12,0,0,0
야촌,43333,0,5,0,5,0,0
약대사거리,57006,2738,523,2738,523,0,105
약대사거리,57010,291,2878,291,2878,0,102
약대주민지원센터.약대초등학교,55080,968,1882,968,1882,0,91
약대주민지원센터.약대초등학교,55088,1765,585,1765,585,0,75
약암호텔,80071,506,73,504,73,2,18
약암호텔,80072,27,424,27,424,0,14
얀센백신,38519,107,0,107,0,0,3
얀센백신,38520,8,378,8,378,0,12
양갑리마을회관,90283,10,52,10,52,0,2
양갑리마을회관,90307,39,0,39,0,0,1
양갑리입구,90282,0,9,0,9,0,0
양갑리입구,90308,18,3,18,3,0,0
양곡도매시장,31037,1372,363,1372,363,0,55
양곡버스정류장,80115,182,707,180,707,2,28
양곡사거리.양촌터미널,80116,511,171,506,171,5,22
양골,43987,23,0,23,0,0,0
양골,43989,1,35,1,35,0,1
양구(오상1리),43262,6,48,6,48,0,1
양구(오상1리),43563,89,10,87,10,2,3
양달마을,43910,61,62,61,62,0,3
양달마을,43911,2,0,2,0,0,0
양도,43074,3,14,2,14,1,0
양도,43075,22,46,22,46,0,2
양도면사무소(나무),43912,383,353,378,353,5,23
양도면사무소(쉘터),43913,581,353,564,353,17,30
양도사거리.대림아파트.신안아파트,80076,892,66,892,66,0,30
양도사거리.삼용아파트,80077,108,776,108,776,0,28
양도초등학교,43329,193,137,190,137,3,10
양도초등학교,43568,156,175,152,175,4,10
양로원,40111,481,2559,481,2559,0,98
양로원,40113,2289,397,2289,397,0,86
양사면사무소,43501,19,30,19,30,0,1
양사면사무소,43658,30,44,30,44,0,2
양사우체국,43465,35,17,35,17,0,1
양사우체국,43736,25,55,24,55,1,2
양사초등학교,43466,66,20,66,20,0,2
양사초등학교,43734,15,53,10,53,5,2
양사파출소,43722,3,8,3,8,0,0
양수장,43592,95,0,94,0,1,3
양수장,43781,2,130,2,130,0,4
양오1리마을회관,43454,0,62,0,62,0,2
양오1리마을회관,43666,54,0,54,0,0,1
양오2리경로당,43453,0,37,0,37,0,1
양오2리경로당,43625,148,0,141,0,7,4
양오2리앞,90049,0,25,0,25,0,0
양오리저수지마을,90102,0,24,0,24,0,0
양오리저수지마을,90103,83,1,80,1,3,2
양오저수지입구,90100,0,5,0,5,0,0
양오저수지입구,90101,12,0,12,0,0,0
양왕마을,43927,9,3,9,3,0,0
양왕마을,43928,4,34,4,34,0,1
양재역,31073,14376,4132,14376,4132,0,597
양재역.서초문화예술회관,31008,2600,3815,2600,3815,0,206
양재역.서초문화예술회관,31010,2510,2124,2510,2124,0,149
양재역말죽거리.강남베드로병원,23318,267,123,267,123,0,12
양지공원,38133,6936,4802,6931,4802,5,378
양지촌,43163,11,3,11,3,0,0
양지촌,43342,11,11,11,11,0,0
양진말입구,90057,0,41,0,41,0,1
양촌중학교,41629,513,880,503,880,10,44
양촌중학교,41630,290,369,287,369,3,21
양평해장국,44145,17,7,15,7,2,0
양평해장국,44178,6,4,6,4,0,0
어두,43206,0,15,0,15,0,0
어두,43280,3,0,3,0,0,0
어두마을,43155,91,1,91,1,0,2
어두마을,43322,7,67,7,67,0,2
어류정입구,90175,27,30,27,30,0,1
어류정입구,90176,9,37,8,37,1,1
어류정입구,90312,1,2,1,2,0,0
어류정항,90323,4,2,4,2,0,0
어류정항,90400,12,1,12,1,0,0
어린이집앞,43402,132,2,121,2,11,4
어린이집앞,43585,6,144,6,144,0,4
에덴하우스,42788,562,1580,562,1580,0,69
에몬스가구,39023,3140,4343,3136,4343,4,241
에몬스가구,39024,4530,2321,4530,2321,0,221
에스틸,89232,241,51,241,51,0,9
에이에프티,39110,985,2619,985,2619,0,116
에코메트로10단지,39728,412,204,412,204,0,19
에코메트로10단지,39736,92,308,92,308,0,12
에코메트로11단지,39652,2850,4167,2848,4167,2,226
에코메트로11단지후문,39701,655,1750,655,1750,0,77
에코메트로12단지,39651,3508,2529,3508,2529,0,194
에코메트로12단지,39653,32,834,32,834,0,27
에코메트로12단지정문,39650,129,122,127,122,2,8
에코메트로5단지,92076,29,105,28,105,1,4
에코메트로5단지·논현센트럴뷰,39779,696,1283,696,1283,0,63
에코메트로6단지,39716,3474,315,3450,315,24,122
에코메트로6단지,39758,85,975,85,975,0,34
에코메트로7단지,39714,9608,4952,9604,4952,4,469
에코메트로7단지,39715,5400,7176,5400,7176,0,405
에코메트로9단지,39750,6773,1303,6768,1303,5,260
에코메트로9단지,39752,2282,4364,2282,4364,0,214
에코메트로더타워,39711,67,707,64,707,3,24
에코크레이션,89449,236,2,235,2,1,7
에코크레이션,89450,1,90,1,90,0,2
엑스포빌리지10단지,38460,2559,1269,2556,1269,3,123
엑스포빌리지9단지,38482,2852,6941,2851,6941,1,315
엑슬루타워,37187,3253,9028,3228,9028,25,396
엑슬루타워,42836,3218,12164,3209,12164,9,496
엘리지안타운,42394,1493,1668,1486,1668,7,101
엘아이지식산업센터,39944,287,960,287,960,0,40
엘아이지식산업센터(맞은편),92029,616,279,616,279,0,28
엘지슈퍼,39457,1252,2370,1252,2370,0,116
엠파크타워,42025,3786,4657,3782,4657,4,272
엠파크타워,42026,4706,3875,4703,3875,3,276
여고입구,90232,456,400,425,400,31,27
여고입구,90233,1302,572,1293,572,9,60
여성의광장,38084,3463,4112,3452,4112,11,244
여성의광장,38085,4099,4465,4060,4465,39,276
여우고개,43980,4,96,4,96,0,3
여우고개,43981,85,68,83,68,2,4
여우별펜션,44142,5,8,5,8,0,0
여우별펜션,44179,5,0,5,0,0,0
여우재,35147,427,457,427,457,0,28
여의도역,19155,428,4,428,4,0,13
여의도역,19156,126,1257,126,1257,0,44
여의도환승센터,19007,12,477,12,477,0,15
여차리,43424,18,38,18,38,0,1
여차리,43472,32,25,31,25,1,1
여차리회관,43505,25,15,24,15,1,1
여차리회관,43525,51,25,50,25,1,2
역삼역.포스코타워역삼,23288,1151,1085,1151,1085,0,72
연락골,39662,11,33,11,33,0,1
연락골,39665,15,7,15,7,0,0
연리입구,43267,60,0,59,0,1,1
연리입구,43614,0,38,0,38,0,1
연미고개,43198,1,86,0,86,1,2
연미고개,43711,128,0,123,0,5,4
연미정,43193,166,0,134,0,32,5
연미정,43621,1,104,1,104,0,3
연성교회,37278,5720,5185,5698,5185,22,351
연세농장,39851,25,2,25,2,0,0
연세대,39725,2540,6161,2540,6161,0,280
연세대,39861,5369,2619,5369,2619,0,257
연세대송도캠퍼스입구,38489,9635,4825,9635,4825,0,466
연세대앞,22022,7,6,7,6,0,0
연세대학교앞,22058,3204,36,3204,36,0,104
연수1동행정복지센터,38248,219,504,216,504,3,23
연수1동행정복지센터,38251,1224,1201,1201,1201,23,78
연수1차아파트,38187,5484,3075,5480,3075,4,276
연수2차아파트,38195,633,1412,620,1412,13,65
연수3동행정복지센터,38262,1627,675,1627,675,0,74
연수경찰서,38111,3351,2829,3330,2829,21,199
연수고등학교,38104,745,2798,726,2798,19,114
연수구청,38089,9240,4769,9226,4769,14,451
연수구청,38093,4062,10937,4059,10937,3,483
연수구청입구,38095,5856,4652,5854,4652,2,338
연수꿈담도서관,38103,8778,6208,8760,6208,18,483
연수병원,38296,5148,2476,5114,2476,34,245
연수여자고등학교,38092,2591,3673,2589,3673,2,202
연수역,38506,2454,2682,2430,2682,24,165
연수역,38507,1302,1989,1301,1989,1,106
연수역북측입구,38572,1410,2680,1409,2680,1,131
연수역북측입구,38573,2067,2247,2067,2247,0,139
연수우체국,38280,7283,4616,7283,4616,0,383
연수우체국,38314,2333,1016,2333,1016,0,108
연수주공3차아파트,38188,3886,4233,3880,4233,6,261
연수중학교,38194,2032,1693,2012,1693,20,120
연수중학교,38196,1070,974,1065,974,5,65
연수초등학교,38290,11072,10333,11034,10333,38,690
연수초등학교,38293,4471,3969,4471,3969,0,272
연수한양1차아파트,38091,2730,5852,2729,5852,1,276
연안동행정복지센터,35063,137,10538,135,10538,2,344
연안부두(신선초등학교),35097,1016,3649,989,3649,27,150
연안부두로삼거리,35754,1,705,1,705,0,22
연안부두바다쉼터,35049,1022,28,1011,28,11,33
연안부두어시장,35071,72,7119,72,7119,0,231
연안부두어시장,35072,7895,146,7837,146,58,259
연안아파트,35075,9507,2125,9481,2125,26,375
연안아파트,35076,1446,10056,1431,10056,15,371
연안여객터미널,35057,5722,49,5671,49,51,186
연안여객터미널,35061,28,3615,23,3615,5,117
연안여객터미널,90115,50,39,50,39,0,2
연안여객터미널,90116,14,98,14,98,0,3
연안여객터미널입구,35068,1799,50,1763,50,36,59
연안초등학교,35064,17057,281,16867,281,190,559
연안초등학교,35067,129,12615,124,12615,5,411
연지-기점,90256,2779,2706,2776,2706,3,176
연학초등학교,37137,7548,1946,7534,1946,14,306
연학초등학교,37138,1566,7198,1553,7198,13,282
연합의원,42186,4190,1647,4168,1647,22,188
연화중학교,38117,2709,3246,2704,3246,5,192
연흥아파트,37567,3553,4235,3530,4235,23,251
연흥아파트,37568,2442,6661,2432,6661,10,293
연희공원,42950,55,121,55,121,0,5
연희동광명아파트(사계절썰매장),42314,1541,2009,1537,2009,4,114
연희동광명아파트(사계절썰매장),42599,1562,2142,1559,2142,3,119
연희동행정복지센터,42311,631,1401,628,1401,3,65
연희동행정복지센터,42312,1539,1010,1536,1010,3,82
열우물사거리,40052,13,284,13,284,0,9
열우물전통시장,40028,517,2455,512,2455,5,95
열우물전통시장,40030,2046,587,2014,587,32,84
열우물전통시장입구,40036,2510,582,2449,582,61,99
열우물전통시장입구,40038,464,4009,464,4009,0,144
열우물테니스경기장,40053,3790,3490,3764,3490,26,234
열우물테니스경기장,40054,895,1142,890,1142,5,65
열우물테니스경기장,40063,387,1237,381,1237,6,52
열우물테니스경기장,40064,303,726,300,726,3,33
열우물테니스경기장,42023,4406,4917,4372,4917,34,300
열우물테니스경기장,42024,3345,3445,3304,3445,41,219
염전공원,37681,1838,11,1792,11,46,59
영골,43954,9,2,9,2,0,0
영골,43955,0,22,0,22,0,0
영남1단지.고합아파트,70164,222,208,221,208,1,13
영남아파트,37060,4604,3742,4604,3742,0,269
영남아파트,37063,5298,4762,5298,4762,0,324
영남아파트,38203,2779,1706,2765,1706,14,144
영남아파트,38205,985,2867,978,2867,7,124
영림몰딩도어,39943,73,131,73,131,0,6
영림산업,39028,716,3660,716,3660,0,141
영림임업,39026,1066,3745,1066,3745,0,155
영사목장 앞,90390,0,20,0,20,0,0
영사목장 앞,90391,3,4,3,4,0,0
영선고등학교,40853,3,944,3,944,0,30
영은교회,43037,46,29,45,29,1,2
영은교회,43139,13,117,13,117,0,4
영은슈퍼,89052,8,805,8,805,0,26
영은슈퍼,89064,891,10,891,10,0,29
영음교회.효성해링턴플레이스,41422,2934,452,2925,452,9,109
영종KCC스위첸.한양수자인,35449,410,2897,410,2897,0,106
영종KCC스위첸옆문,35755,1089,8285,1089,8285,0,302
영종KCC스위첸옆문,35756,8113,666,8112,666,1,283
영종LH2단지,35483,720,1297,720,1297,0,65
영종LH67단지,35872,940,1009,940,1009,0,62
영종LH67단지,35873,1653,872,1652,872,1,81
영종LH아파트입구,35390,120,73,120,73,0,6
영종e편한세상센텀베뉴·센트럴푸르지오자이,35660,6114,4437,6112,4437,2,340
영종e편한세상센텀베뉴·화성파크드림2차,35886,4495,4490,4492,4490,3,289
영종고등학교,35493,2402,2955,2401,2955,1,172
영종고등학교,35496,2438,2366,2437,2366,1,154
영종공원묘지입구,35626,9,52,9,52,0,1
영종공원묘지입구,35627,9,5,9,5,0,0
영종교회,35306,339,318,339,318,0,21
영종교회,35545,1095,773,1095,773,0,60
영종국제병원,35881,671,2848,667,2848,4,113
영종대교휴게소,42942,0,68,0,68,0,2
영종대교휴게소,42943,112,24,112,24,0,4
영종동행정복지센터,35672,214,214,214,214,0,13
영종동행정복지센터,35673,130,63,128,63,2,6
영종물류고등학교·영종자이아파트,35314,4627,4396,4625,4396,2,291
영종물류고등학교앞·영종자이아파트,35307,6257,4396,6249,4396,8,343
영종버스공영차고지,35837,24,1,21,1,3,0
영종버스공영차고지,35838,32,98,15,98,17,4
영종블루오션,35819,324,210,322,210,2,17
영종블루오션,35820,118,225,117,225,1,11
영종블루오션2차,35876,3099,1795,3098,1795,1,157
영종블루오션2차,35877,2119,3465,2119,3465,0,180
영종선착장입구,35833,2213,2192,2211,2192,2,142
영종선착장입구,35834,11,614,11,614,0,20
영종성당.정도사,35850,5,111,5,111,0,3
영종성당.정도사,35851,10,34,10,34,0,1
영종센트럴푸르지오자이·e편한세상센텀베뉴,35661,6172,4842,6167,4842,5,355
영종소방서,35765,4,49,4,49,0,1
영종아레나,35830,164,22,163,22,1,6
영종아레나,35831,4,212,2,212,2,6
영종역,35566,57567,1067,57540,1067,27,1891
영종역,35567,4299,13127,4289,13127,10,562
영종역(2번출구),35870,24,2136,24,2136,0,69
영종역(청라행),35620,39,13453,39,13453,0,435
영종역사관,35624,129,123,129,123,0,8
영종역사관,35625,65,197,63,197,2,8
영종유승한내들스카이스테이,35759,2220,921,2220,921,0,101
영종유승한내들스카이스테이,35760,845,1486,845,1486,0,75
영종자이아파트,35835,46,98,46,98,0,4
영종자이아파트,35836,389,76,389,76,0,15
영종장로교회,35580,36,95,34,95,2,4
영종장로교회,35581,40,43,40,43,0,2
영종주공7단지,35111,1460,1645,1457,1645,3,100
영종주야간보호센터,35854,19,8,19,8,0,0
영종주야간보호센터,35855,0,3,0,3,0,0
영종중학교,35463,2710,1811,2708,1811,2,145
영종중학교,35464,5026,1778,5024,1778,2,219
영종진공원,35276,1049,553,1046,553,3,51
영종진공원,35279,213,1708,212,1708,1,61
영종풍림아이원1차,35110,101,229,99,229,2,10
영종하늘도서관,35585,1491,1007,1491,1007,0,80
영종하늘도서관,35586,1024,1008,1022,1008,2,65
영종화성파크드림2차·e편한세상센텀베뉴,35885,4059,3181,4056,3181,3,233
영종힐스테이트(904동),35880,461,1096,460,1096,1,50
영진아파트,40551,66,433,66,433,0,16
영창한의원,40452,7937,6353,7895,6353,42,460
영풍아파트,36040,9754,2787,9717,2787,37,404
영풍아파트,39546,39,310,39,310,0,11
영흥감리교회입구,44201,11,8,11,8,0,0
영흥공립어린이집,44205,0,1,0,1,0,0
영흥대교입구,44100,0,2,0,2,0,0
영흥대교입구,44180,1,0,1,0,0,0
영흥면사무소,44131,2,4,2,4,0,0
영흥면사무소,44181,10,0,10,0,0,0
영흥버스터미널,44004,4228,3414,3979,3414,249,246
영흥버스터미널,44116,128,24,107,24,21,4
영흥빌라,44182,3,0,3,0,0,0
영흥수협공판장입구,44009,443,4,437,4,6,14
영흥수협공판장입구,44010,0,660,0,660,0,21
영흥어린이집,44137,15,26,15,26,0,1
영흥우체국,44107,16,18,15,18,1,1
영흥우체국,44183,29,29,29,29,0,1
영흥종합운동장앞,44120,0,26,0,26,0,0
영흥종합운동장앞,44192,12,0,12,0,0,0
영흥초교입구,44101,25,5,22,5,3,0
영흥초교입구,44184,1,20,1,20,0,0
영흥칼국수,44136,0,8,0,8,0,0
영흥플로레도커피,44144,3,9,3,9,0,0
영흥플로레도커피,44185,2,6,2,6,0,0
예단포,35319,126,185,122,185,4,10
예단포,35395,177,68,176,68,1,7
예단포물양장,35622,123,4,120,4,3,4
예단포물양장,35623,20,73,20,73,0,3
예드림빌라입구,35546,86,20,86,20,0,3
예드림빌라입구,35547,24,70,24,70,0,3
예림임업,39053,28,465,28,465,0,15
예림임업,39054,322,122,322,122,0,14
예비군교육장,41272,949,1581,949,1581,0,81
예비군교육장,41273,2058,2654,2049,2654,9,152
예비군교육장입구,90010,28,0,27,0,1,0
예비군교육장입구,90011,2,22,2,22,0,0
예비군훈련장,43201,159,6,157,6,2,5
예비군훈련장,43315,24,154,24,154,0,5
예송중학교,38592,2300,1526,2300,1526,0,123
예송중학교,38593,2221,2529,2180,2529,41,153
예술회관사거리,37254,3261,6460,3221,6460,40,313
예술회관역,39206,3319,10756,3293,10756,26,454
예술회관역(4번출구),39207,5396,5559,5381,5559,15,353
예원앞,41499,50,103,50,103,0,4
예원앞,41515,54,0,54,0,0,1
옐림교회,40854,5508,4901,5505,4901,3,335
옐림교회앞,35684,37,30,37,30,0,2
옐림교회앞,35694,32,60,31,60,1,2
오공본드,39108,4602,3248,4602,3248,0,253
오관물입구,35859,2,15,2,15,0,0
오관물입구,35860,21,2,21,2,0,0
오두돈대,43361,51,7,50,7,1,1
오두돈대,43536,9,37,9,37,0,1
오두리(넙성입구),43638,11,16,11,16,0,0
오두리(넙성입구),43675,2,38,2,38,0,1
오두리종점,43137,85,9,82,9,3,3
오두리종점,43529,14,45,13,45,1,1
오두마을입구,43557,4,0,4,0,0,0
오두마을입구,43647,0,9,0,9,0,0
오라니마을,80360,85,156,85,156,0,7
오류골,43013,269,58,267,58,2,10
오류골,43014,37,202,37,202,0,7
오류내,43389,5,298,4,298,1,9
오류내,43757,328,17,318,17,10,11
오류동마을,41353,1108,643,1107,643,1,56
오류동마을,41354,945,2436,940,2436,5,109
오류동역입구,89058,3,37,3,37,0,1
오류동역입구,89066,59,305,58,305,1,11
오리정,80125,894,106,882,106,12,32
오리정,80126,137,770,128,770,9,29
오상리고인들,43265,18,13,18,13,0,1
오상리고인들,43379,13,21,12,21,1,1
오상입구,43119,19,8,19,8,0,0
오상입구,43120,1,27,1,27,0,0
오상입구,43390,6,60,6,60,0,2
오상입구,43565,32,8,30,8,2,1
오성교회,43555,12,2,12,2,0,0
오성교회,43853,2,27,2,27,0,0
오성아파트,40480,5981,1664,5940,1664,41,246
오성아파트,40487,1511,4667,1502,4667,9,199
오성아파트,40493,480,1794,476,1794,4,73
오성아파트,40721,184,414,181,414,3,19
오성정밀,39490,428,669,428,669,0,35
오이도역,70031,685,5004,677,5004,8,183
오이도역,70032,4849,806,4789,806,60,182
오정휴먼시아(중),57044,386,2321,386,2321,0,87
오정휴먼시아(중),57045,2447,347,2447,347,0,90
오조산공원,41246,1576,1240,1576,1240,0,90
오조산공원,41249,3170,3085,3141,3085,29,201
오조산공원,41621,12,420,9,420,3,13
옥골.옥토끼우주센터,43033,146,211,146,211,0,11
옥골.옥토끼우주센터,43561,117,55,116,55,1,5
옥골사거리,38731,389,3541,386,3541,3,126
옥골사거리,38732,358,168,355,168,3,16
옥금말,43952,104,11,66,11,38,3
옥금말,43953,9,97,9,97,0,3
옥련1동행정복지센터,38217,8930,4761,8915,4761,15,441
옥련2동행정복지센터(옥련우체국),38450,2302,167,2302,167,0,79
옥련2동행정복지센터(옥련우체국),38451,564,1898,564,1898,0,79
옥련고개,38212,1578,3471,1573,3471,5,162
옥련고개,38219,1318,1073,1315,1073,3,77
옥련동성당,38330,948,2066,948,2066,0,97
옥련사거리,38170,826,1303,826,1303,0,68
옥련사거리,38171,1944,1884,1944,1884,0,123
옥련여고입구,38271,642,415,642,415,0,34
옥련여고입구,38273,697,2734,691,2734,6,110
옥련중학교,38470,2788,4601,2760,4601,28,238
옥련지구대,38223,1081,4281,1065,4281,16,172
옥련초등학교,38146,3725,4705,3696,4705,29,271
옥림교회,43202,52,1,49,1,3,1
옥림교회,43716,1,39,1,39,0,1
옥림슈퍼,43205,245,15,241,15,4,8
옥림슈퍼,43720,13,91,13,91,0,3
옥림에덴,90418,13,113,13,113,0,4
옥림에덴,90419,11,2,11,2,0,0
온누리병원,42425,291,958,288,958,3,40
온수교차로,90231,1,73,1,73,0,2
온수리,43018,3857,1685,3811,1685,46,178
온수리,43020,2431,2742,2410,2742,21,166
온수시장,43019,66,28,64,28,2,3
온수시장,43095,23,173,21,173,2,6
올리브백화점,39359,3341,1660,3322,1660,19,161
올리브백화점,39363,1911,2137,1886,2137,25,130
올리브백화점,39364,13118,13001,13077,13001,41,842
올리브백화점,39589,15998,17993,15957,17993,41,1096
올리브백화점,39746,14200,17504,14126,17504,74,1022
올리브백화점,39747,21510,25097,21456,25097,54,1503
올림픽공원,39209,3357,4444,3341,4444,16,251
올림픽공원,39210,284,653,280,653,4,30
올림픽생활기념관,39349,4919,5563,4913,5563,6,338
옹장골,43171,6,79,6,79,0,2
옹장골,43230,100,1,98,1,2,3
옹진군청,37019,1394,2211,1390,2211,4,116
옹진군청,37020,8023,1177,8014,1177,9,296
완정공단입구,42409,5334,3006,5331,3006,3,269
완정사거리,42561,29296,7802,29258,7802,38,1196
완정사거리,42562,171,2087,171,2087,0,72
완정역,42673,12002,38163,11996,38163,6,1618
완정역,42674,7717,21485,7711,21485,6,942
완정초등학교.검단도서관,42414,3153,5653,3152,5653,1,284
완정초등학교.검단도서관,42415,3370,5233,3367,5233,3,277
왕궁가든,41289,1780,2310,1775,2310,5,131
왕궁가든,41291,1836,3387,1808,3387,28,168
왕길고가,42551,953,28,948,28,5,31
왕길고가,42552,5,759,5,759,0,24
왕길동,42386,13,372,13,372,0,12
왕길동,42387,188,194,186,194,2,12
왕길동(기점),42699,436,11,389,11,47,14
왕길동종점,42594,52,221,20,221,32,8
왕리물,90098,0,2,0,2,0,0
왕리물,90099,0,1,0,1,0,0
왕산골,35490,78,239,75,239,3,10
왕산골,35491,224,61,224,61,0,9
왕산교,35632,106,46,103,46,3,4
왕산교,35633,5,121,5,121,0,4
왕산차고지,35403,855,323,850,323,5,38
왕산차고지,35720,180,55,178,55,2,7
왕산해수욕장(왕산요트경기장),35020,1139,228,1138,228,1,44
왕산해수욕장(왕산요트경기장),35021,309,1042,306,1042,3,43
외1리마을회관앞,44096,35,26,33,26,2,1
외1리마을회관앞,44186,3,0,3,0,0,0
외1리소장골,44133,9,25,8,25,1,1
외뜰,43687,7,10,5,10,2,0
외뜰,43745,5,13,5,13,0,0
외리보건지소앞,44095,32,29,31,29,1,1
외리보건지소앞,44187,1,0,1,0,0,0
외주,43181,66,15,66,15,0,2
외주,43241,4,81,4,81,0,2
외포1리,43283,12,87,12,87,0,3
외포고개,43244,17,60,16,60,1,2
외포고개,43366,6,99,6,99,0,3
외포리,43556,959,1171,924,1171,35,68
외포리(싱싱마트),90376,31,12,28,12,3,1
외포리(하나로마트),90387,7,146,7,146,0,4
외포리(하나로마트),90388,113,39,109,39,4,4
외포리소공원,90127,5,18,3,18,2,0
외포리소공원,90128,0,37,0,37,0,1
외포리정미소,43240,101,6,100,6,1,3
외포삼거리,43110,314,112,302,112,12,13
외포삼거리,43285,15,83,15,83,0,3
요곡,43655,135,171,130,171,5,9
요곡,43762,69,39,69,39,0,3
요골,43590,51,1,50,1,1,1
요골,43780,0,14,0,14,0,0
용갈비,40338,88,2809,88,2809,0,93
용구물길,90385,1,35,1,35,0,1
용구물길,90386,12,0,8,0,4,0
용궁사입구,35578,236,896,236,896,0,36
용궁사입구,35579,823,80,814,80,9,29
용남시장,37232,16814,13735,16739,13735,75,985
용남시장,37236,16835,17885,16750,17885,85,1120
용남파출소,37177,7698,2532,7695,2532,3,330
용남파출소,37184,4194,10619,4185,10619,9,477
용담공원,38172,1349,2245,1347,2245,2,115
용담공원,38177,2584,1554,2577,1554,7,133
용담마을,38191,4690,5648,4663,5648,27,333
용담마을,38192,4959,3068,4910,3068,49,258
용담어촌계앞,44097,10,3,9,3,1,0
용담어촌계앞,44189,1,0,1,0,0,0
용당사터,43537,85,9,81,9,4,3
용당사터,43677,5,35,5,35,0,1
용유동행정복지센터,35017,51,37,51,37,0,2
용유동행정복지센터,35211,53,132,53,132,0,5
용유동행정복지센터,35411,165,262,161,262,4,13
용유동행정복지센터,35412,229,99,227,99,2,10
용유역,35433,308,1126,308,1126,0,46
용유초등학교,35022,264,33,261,33,3,9
용유초등학교,35023,50,335,41,335,9,12
용유초등학교,35409,73,503,73,503,0,18
용유초등학교삼거리,35410,423,32,423,32,0,14
용일사거리,37208,27964,21649,27929,21649,35,1600
용일사거리,37218,26213,27516,26129,27516,84,1733
용일사거리,37251,960,1381,960,1381,0,75
용일초등학교,37233,11984,7972,11964,7972,20,643
용일초등학교,37237,7343,15659,7292,15659,51,742
용정리 사거리,43721,0,137,0,137,0,4
용정마을회관,43370,0,45,0,45,0,1
용정마을회관,43615,269,4,249,4,20,8
용정초등학교,37297,1287,786,1287,786,0,66
용정초등학교,37299,698,1884,698,1884,0,83
용진주택,43084,240,65,237,65,3,9
용진주택,43085,9,32,9,32,0,1
용진진,43639,6,38,4,38,2,1
용진진,43678,15,14,15,14,0,0
용현2동행정복지센터,37653,1252,255,1252,255,0,48
용현2동행정복지센터,37654,313,1521,313,1521,0,59
용현3동행정복지센터.보훈병원,37221,23546,17367,23388,17367,158,1319
용현3동행정복지센터.보훈병원,37224,12225,14574,12197,14574,28,864
용현5동행정복지센터,37129,264,765,264,765,0,33
용현고가교,37550,157,1959,156,1959,1,68
용현고가교,37611,7834,1477,7834,1477,0,300
용현고개,37178,4691,4834,4681,4834,10,307
용현고개,37497,5330,5829,5324,5829,6,359
용현동농협,37117,399,2707,399,2707,0,100
용현동상우빌라,37564,4,609,4,609,0,19
용현동상우빌라,37565,1275,100,1248,100,27,44
용현동성원상떼빌아파트,37546,398,527,386,527,12,29
용현사거리,37212,1936,1561,1925,1561,11,112
용현사거리,37213,1481,4017,1465,4017,16,177
용현시장,37227,22537,27465,22455,27465,82,1612
용현시장,37230,24517,14855,24446,14855,71,1270
용현시장,37268,5775,3451,5705,3451,70,297
용현시장,37270,4253,5255,4225,5255,28,306
용현아파트,37153,30,319,30,319,0,11
용현중학교,37021,3124,558,3116,558,8,118
용현중학교,37028,1069,2483,1067,2483,2,114
용현초등학교,37508,1,782,1,782,0,25
용현초등학교입구,37128,10666,4053,10635,4053,31,474
용현초등학교입구,37134,6769,12451,6731,12451,38,620
용화사(길상낚시터),90077,12,57,12,57,0,2
용화사(길상낚시터),90080,30,30,30,30,0,1
우뢰촌,43425,125,48,122,48,3,5
우뢰촌,43792,80,71,73,71,7,4
우리자동차,35223,737,269,648,269,89,32
우림라이온스밸리,40592,353,4351,351,4351,2,151
우림라이온스밸리,40594,8222,1306,8206,1306,16,307
우림필유아파트,42924,3202,1496,3194,1496,8,151
우림필유아파트,42925,1110,2553,1109,2553,1,118
우물골,43929,30,49,30,49,0,2
우물골,43930,19,49,18,49,1,2
우미린1단지정문,35583,2817,749,2814,749,3,115
우미린1단지정문,35584,1138,2519,1138,2519,0,117
우미린1단지후문,35461,1614,3953,1614,3953,0,179
우미린1단지후문,35462,4223,759,4222,759,1,160
우미린2단지정문,35512,5264,1397,5260,1397,4,214
우미린2단지정문,35513,1989,5784,1987,5784,2,250
우미린2단지후문,35454,2871,1013,2871,1013,0,125
우미린더시그니처(후문),89443,2911,317,2911,317,0,104
우성1차아파트,38094,4285,4593,4285,4593,0,286
우성1차아파트,39834,739,20,721,20,18,24
우성2차아파트(옥련동),38356,2634,951,2628,951,6,115
우성2차아파트·원인재역(4번출구),38150,3093,7242,3070,7242,23,333
우성4차,40185,6821,250,6821,250,0,228
우성4차,40187,197,6142,197,6142,0,204
우성4차후문,40730,155,2633,155,2633,0,89
우성4차후문,40731,3263,203,3263,203,0,111
우성아파트,38143,4730,2302,4727,2302,3,226
우성아파트,38357,1141,2184,1124,2184,17,107
우성아파트,40341,980,1692,975,1692,5,86
우성아파트,42717,3406,5868,3406,5868,0,299
우성아파트,42718,2613,2386,2612,2386,1,161
우성아파트.은행교회,70026,463,47,461,47,2,16
우저서원(대성주유소),35214,134,98,134,98,0,7
우저서원(대성주유소),35215,72,698,72,698,0,24
우정아파트,37675,168,332,168,332,0,16
우주골드타운빌라,40863,732,1149,732,1149,0,60
우주골드타운빌라,40864,390,1141,390,1141,0,49
우주아파트,38252,7201,8504,7191,8504,10,506
우진기계,89106,8,359,8,359,0,11
우진아파트,37158,1819,1767,1804,1767,15,115
우진아파트,37159,249,2566,245,2566,4,90
우체국사거리,39694,1124,2009,1124,2009,0,101
우체국사거리,39695,1739,748,1739,748,0,80
우체국사거리,39704,2627,2389,2624,2389,3,161
욱일아파트후문,40877,1629,2431,1625,2431,4,130
운남교차로,35435,88,152,87,152,1,7
운남교차로,35444,161,152,161,152,0,10
운남교차로,35524,71,48,70,48,1,3
운남교차로,35582,16,31,15,31,1,1
운남교차로 입구,35839,18,47,18,47,0,2
운남교차로 입구,35840,19,30,18,30,1,1
운남교차로.잔다리,35595,541,320,541,320,0,27
운남교차로.잔다리,35596,214,569,214,569,0,25
운남동,35268,144,268,144,268,0,13
운남동,35281,250,285,250,285,0,17
운남동우체국,35848,335,175,335,175,0,16
운남동우체국,35849,197,383,195,383,2,18
운남초교사거리,35706,41,151,41,151,0,6
운남초교사거리,35707,366,194,366,194,0,18
운북공영차고지,35779,424,3,424,3,0,13
운북공영차고지,35783,0,451,0,451,0,14
운서2차SKVIEW스카이시티,35882,3945,1360,3938,1360,7,171
운서2차SKVIEW스카이시티,35883,1716,3602,1708,3602,8,171
운서SKVIEW 스카이시티,35780,50,180,50,180,0,7
운서SKVIEW·세계로향하는교회,35781,125,176,125,176,0,9
운서역,35242,28920,16121,28891,16121,29,1452
운서역,35257,8654,17539,8652,17539,2,844
운서역(남동측),35775,419,929,419,929,0,43
운서역(남동측),35776,1079,1102,1079,1102,0,70
운서역(하워드존슨호텔),35747,4723,4339,4723,4339,0,292
운서역반도유보라,35878,2769,2353,2769,2353,0,165
운서역반도유보라,35879,1909,1804,1909,1804,0,119
운서초등학교,35270,7382,2323,7382,2323,0,313
운서초등학교,35282,2585,4189,2585,4189,0,218
운양역,80348,266,491,266,491,0,24
운양역,80351,354,132,353,132,1,15
운연동,39374,589,659,588,659,1,40
운연동,39379,504,629,504,629,0,36
운연동,39673,30,0,30,0,0,0
운연삼거리,39987,716,1507,704,1507,12,71
운연삼거리,39988,61,609,57,609,4,21
운연역,39954,10633,11549,10626,11549,7,715
운연역,92026,6098,6826,6094,6826,4,416
운연천,92027,267,965,266,965,1,39
운연천,92028,461,275,461,275,0,23
운전면허시험장,39005,3131,1208,3131,1208,0,139
울레기,43179,23,204,23,204,0,7
울레기,43548,206,15,192,15,14,7
웃말,90169,4,10,3,10,1,0
웃말,90170,4,3,4,3,0,0
원당고등학교,42459,2230,3075,2228,3075,2,171
원당교,89485,320,160,317,160,3,15
원당교,89486,55,1401,54,1401,1,46
원당사거리.검단선사박물관,42446,19282,8125,19248,8125,34,884
원당사거리.검단선사박물관,42447,10977,18239,10967,18239,10,942
원당중고등학교,42460,55,237,55,237,0,9
원당중고등학교,42462,126,220,126,220,0,11
원동초등학교,39656,1628,7186,1611,7186,17,284
원동초등학교,39657,10128,2044,10106,2044,22,392
원성골,35434,38,147,37,147,1,5
원성골,35445,86,257,86,257,0,11
원수리마을,90251,1,7,1,7,0,0
원수리마을,90252,10,3,10,3,0,0
원인재역(1번출구),38162,1437,5913,1431,5913,6,237
원인재역(4번출구),38153,11068,3212,11051,3212,17,460
원인재역(6번출구),38166,5712,2409,5712,2409,0,261
원적산터널,40821,1597,3245,1591,3245,6,156
원적산터널,40822,2133,3148,2131,3148,2,170
원적산터널서측,42666,4788,3955,4786,3955,2,282
원적산터널서측,42667,3517,3849,3512,3849,5,237
원종IC(중),57046,62,3180,62,3180,0,104
원종IC(중),57047,928,78,928,78,0,32
원진운수차고지,89003,822,121,802,121,20,30
원진운수차고지,89004,50,869,10,869,40,29
원창동(기점),89143,2952,30,2951,30,1,96
원창동(기점),89144,5,2892,5,2892,0,93
원창동(종점),42183,15,1110,14,1110,1,36
원창동(종점),42184,1100,653,1037,653,63,56
원흥아파트,38131,24264,15629,24189,15629,75,1286
원흥아파트,38336,32875,21966,32751,21966,124,1769
원흥아파트,42793,85,3,85,3,0,2
월곳삼거리,43188,4,45,4,45,0,1
월곳삼거리,43619,46,1,45,1,1,1
월곶동주민센터.월곶포구,70006,773,211,766,211,7,31
월곶동주민센터.월곶포구,70005,237,1486,234,1486,3,55
월곶어울림센터,25095,86,64,71,64,15,4
월드메르디앙아파트,42161,3989,4657,3954,4657,35,278
월드메르디앙아파트,42163,6001,3338,5981,3338,20,301
월드아파트,42499,7687,10301,7681,10301,6,580
월드아파트,42500,12067,6375,12062,6375,5,594
월미공원,35138,19,450,19,450,0,15
월미공원,35572,110,14,110,14,0,4
월미공원역,35345,79,2058,78,2058,1,68
월미공원역,35346,2971,246,2960,246,11,103
월미도,35148,24112,176,23850,176,262,783
월미도(시티투어),35144,474,10729,455,10729,19,361
월미도문화관,35558,1791,31,1771,31,20,58
월미도종점,35368,149,6102,131,6102,18,201
월미문화의거리,35132,11,3585,11,3585,0,116
월미문화의거리,35219,2365,13,2365,13,0,76
월미테마파크,35128,85,7491,83,7491,2,244
월미테마파크,35502,3924,36,3924,36,0,127
월선포,90041,54,58,50,58,4,3
웨딩타운,22061,183,0,183,0,0,5
웨딩타운,23077,0,30,0,30,0,0
웰카운티,38352,1548,5548,1548,5548,0,228
웰카운티,38353,10461,1440,10461,1440,0,383
웰카운티,42772,1708,3883,1701,3883,7,180
웰카운티17단지,89182,3253,962,3253,962,0,135
웰카운티17단지,89183,562,2801,562,2801,0,108
웰카운티1단지,38648,918,2977,917,2977,1,125
웰카운티1차,42746,1974,1502,1974,1502,0,112
웰카운티1차,42764,2362,1283,2362,1283,0,117
웰카운티2단지,38709,928,630,927,630,1,50
웰카운티4단지,38446,401,374,398,374,3,25
웰카운티4단지,38447,291,1002,291,1002,0,41
윗말,43488,8,4,8,4,0,0
윗말,43839,6,5,5,5,1,0
윗망월,43335,6,61,6,61,0,2
윗망월,43578,113,0,98,0,15,3
유니온프라자,42113,12844,8239,12778,8239,66,680
유림골프장,41469,8,847,8,847,0,27
유림골프장,41667,688,8,688,8,0,22
유성아파트,43086,159,815,156,815,3,31
유성아파트,43087,734,70,723,70,11,25
유수지,39010,534,885,533,885,1,45
유수지,39011,718,2065,717,2065,1,89
유수지근린공원,39019,1093,840,1093,840,0,62
유수지근린공원,39020,678,952,678,952,0,52
유수지길,39003,1184,2227,1182,2227,2,110
유수지길,39004,1406,1037,1404,1037,2,78
유승아파트,42397,2999,480,2993,480,6,112
유승아파트,42398,439,2702,438,2702,1,101
유승아파트(삼성홈타운아파트),41003,3681,3085,3668,3085,13,218
유승아파트(삼성홈타운아파트),41004,2932,3323,2910,3323,22,201
유승아파트(삼성홈타운아파트),41005,6302,2052,6284,2052,18,269
유승아파트(삼성홈타운아파트),41006,1640,6320,1612,6320,28,256
유승아파트(삼성홈타운아파트),41583,1,271,1,271,0,8
유원아파트,37163,5924,10261,5884,10261,40,522
유원아파트,37172,12779,4715,12753,4715,26,564
유진시스템앞,40676,1002,4441,1002,4441,0,175
유진시스템앞,40678,1967,1062,1965,1062,2,97
유진투자증권.파이낸셜뉴스신문,19283,882,39,882,39,0,29
유천아파트,38254,1081,728,1081,728,0,58
유천아파트,38266,7716,5319,7716,5319,0,420
유천아파트후문,38265,396,1084,396,1084,0,47
유현마을.신동아아파트,80001,170,305,170,305,0,15
유현마을.신동아아파트,80073,294,13,294,13,0,9
유현사거리,42484,7234,11894,7234,11894,0,617
유현사거리,42487,7257,6099,7255,6099,2,430
유호엔시티.논현푸르지오,39823,59,1984,57,1984,2,65
육골,18805,1,79,1,79,0,2
육골,62030,6,2,3,2,3,0
윤성아파트,38307,263,1498,260,1498,3,56
윤성아파트(인항고교),37011,2470,3850,2466,3850,4,203
윤성아파트(인항고교),37012,3771,2258,3765,2258,6,194
율도근린공원,89339,352,107,352,107,0,14
율도근린공원,89340,416,491,416,491,0,29
율도근린공원입구,89428,249,226,249,226,0,15
율도근린공원입구,89429,177,133,177,133,0,10
율도입구,42188,1474,1179,1474,1179,0,85
율도입구,42190,923,995,922,995,1,61
율목동행정복지센터,35787,51,126,51,126,0,5
율목동행정복지센터,35801,150,38,150,38,0,6
율목오거리,35786,51,68,51,68,0,3
율목오거리,35802,127,36,127,36,0,5
율생리입구,80016,246,1102,246,1102,0,43
율생리입구,80017,1176,155,1163,155,13,42
은계초등학교.사랑스러운교회,70025,1473,20,1469,20,4,48
은골공원,35599,1557,2659,1557,2659,0,136
은골공원,35600,2176,2233,2168,2233,8,142
은골사거리,35309,168,242,166,242,2,13
은당골,90212,18,7,16,7,2,0
은당골,90213,12,16,11,16,1,0
은봉초등학교,39613,10679,2807,10653,2807,26,435
은봉초등학교,39614,3030,11964,3015,11964,15,483
은성아파트,39321,7318,3218,7300,3218,18,339
은성프레미오,39325,1694,4933,1692,4933,2,213
은영빌라,41089,2275,99,2275,99,0,76
은영아파트,42218,3799,3336,3751,3336,48,230
은지초등학교사거리,42365,5305,5970,5302,5970,3,363
은하마을.중흥마을,55069,466,1428,466,1428,0,61
은하목장앞,43274,3,2,3,2,0,0
은하목장앞,43852,0,12,0,12,0,0
은하쌍용아파트,55062,1251,5627,1251,5627,0,221
은행마을,41198,7591,3079,7573,3079,18,344
은행초등학교,70019,3306,419,3294,419,12,120
을왕리해수욕장,35009,4932,611,4931,611,1,178
을왕리해수욕장,35010,1554,5506,1548,5506,6,227
을왕리해수욕장.더위크앤리조트,35015,3033,713,3027,713,6,120
을왕리해수욕장.더위크앤리조트,35016,952,2708,949,2708,3,118
읍내리마을회관입구,90032,0,21,0,21,0,0
읍내리마을회관입구,90033,35,0,33,0,2,1
응곡,43696,33,58,33,58,0,2
응곡,43749,65,23,65,23,0,2
이강리방앗간,43691,93,8,86,8,7,3
이강리방앗간,43832,6,194,6,194,0,6
이건창생가,43145,42,1,37,1,5,1
이건창생가,43434,1,96,1,96,0,3
이규보묘입구,90065,121,20,121,20,0,4
이규보묘입구,90389,11,126,11,126,0,4
이대역,22015,4349,77,4349,77,0,142
이대역,22057,2789,47,2789,47,0,91
이대역,23036,77,5548,77,5548,0,181
이마트,41122,4211,17422,4189,17422,22,697
이마트,41125,25896,9129,25860,9129,36,1129
이마트송림점,36100,7485,4644,7477,4644,8,391
이안송도,38409,21988,7024,21987,7024,1,935
이영화학,39644,2383,890,2383,890,0,105
이음1로.모아미래도엘리트파크,89514,315,338,315,338,0,21
이음1로.예미지더시그너스,89513,760,570,760,570,0,42
이음2로.디에트르더펠리체,89509,858,117,858,117,0,31
이음2로.파라곤센트럴파크,89510,200,1590,200,1590,0,57
이음5로.금호어울림센트럴,89433,1141,5556,1141,5556,0,216
이음5로.우미린더시그니처,89432,4088,1949,4088,1949,0,194
이음대로.대성베르힐,89440,17489,2316,17480,2316,9,638
이음대로.대성베르힐,89441,3029,23574,3029,23574,0,858
이음대로.디에트르더펠리체,89438,9365,1914,9357,1914,8,363
이음대로.호반써밋,89439,4241,12163,4240,12163,1,529
이촌,43312,0,5,0,5,0,0
이촌,43768,24,0,23,0,1,0
이토상가,39196,8344,2176,8327,2176,17,339
이현(이강리교회),43661,10,120,10,120,0,4
이현(이강리교회),43690,123,9,115,9,8,4
이화1동입구,41487,116,73,116,73,0,6
이화1동입구,41506,35,2,35,2,0,1
이화2동마을회관,41484,13,11,13,11,0,0
이화2동마을회관,41504,63,36,63,36,0,3
이화2동회차지,41486,19,17,19,17,0,1
이화교회앞,41489,23,17,23,17,0,1
이화동노인정,41490,71,30,71,30,0,3
이화동다리,41479,117,524,117,524,0,20
이화동다리,41516,396,18,396,18,0,13
이화진등마을경로당,41601,25,44,25,44,0,2
인고앞,37318,3066,5923,3061,5923,5,289
인고앞,37338,6416,3642,6400,3642,16,324
인고체육관,37305,9655,4853,9649,4853,6,468
인고체육관(동양장사거리),37309,6108,7008,6102,7008,6,423
인내마을,90181,11,23,11,23,0,1
인내마을,90182,16,4,16,4,0,0
인명여자고등학교,37199,29814,4340,29776,4340,38,1101
인명여자고등학교,37205,8812,41658,8803,41658,9,1628
인사리군부대앞,90268,13,32,13,32,0,1
인사리군부대앞,90270,10,0,10,0,0,0
인사리마을회관,90267,2,11,2,11,0,0
인사리마을회관,90271,13,0,13,0,0,0
인사리우무렛골,90266,7,46,7,46,0,1
인사리인현경로당앞,90269,23,27,23,27,0,1
인사리지석교회,90272,3,1,3,1,0,0
인산저수지,43354,118,64,118,64,0,5
인산저수지,43575,66,125,66,125,0,6
인삼농협앞,80305,14,302,14,302,0,10
인삼농협앞,80306,449,19,448,19,1,15
인성여자고등학교,35793,149,772,149,772,0,29
인성여자고등학교,35808,24,436,24,436,0,14
인송빌라,40241,2590,33,2590,33,0,84
인수초등학교,39386,10721,10040,10708,10040,13,669
인수초등학교,39392,14235,12496,14224,12496,11,862
인썸호텔,44134,20,25,16,25,4,1
인아교회,35091,1105,172,1105,172,0,41
인아교회,35094,212,978,212,978,0,38
인재개발원,42281,1284,2242,1279,2242,5,113
인재개발원,42282,2079,1147,2074,1147,5,104
인제고등학교,39548,454,1335,447,1335,7,57
인천가정법원.인천지방법원등기국,37405,9608,12744,9562,12744,46,721
인천가정법원.인천지방법원등기국,37409,23539,21261,23491,21261,48,1445
인천가족공원입구,39493,605,486,605,486,0,35
인천가족공원입구,39495,876,1554,873,1554,3,78
인천가족공원입구,92059,1479,1256,1469,1256,10,88
인천가톨릭대학교,39931,2741,1696,2741,1696,0,143
인천경로당앞,90226,11,20,11,20,0,1
인천경로당앞,90227,12,9,12,9,0,0
인천경연초중학교,89347,73,269,73,269,0,11
인천공항T1(1층13B),35205,32831,315,32760,315,71,1069
인천공항T1(1층2A),35344,46382,2645,46277,2645,105,1581
인천공항T1(1층2B),35202,16850,5117,16850,5117,0,708
인천공항T1(3층13번),35556,2030,19364,2017,19364,13,690
인천공항T1(3층14번),35753,3229,6653,3224,6653,5,318
인천공항T1(3층2번),35032,3512,45880,3507,45880,5,1593
인천공항T1(3층6번),35752,9936,19764,9936,19764,0,958
인천공항T1(3층7번),35203,10574,52856,10554,52856,20,2046
인천공항T1-3층,35325,4,35,4,35,0,1
인천공항T2(1)A(1층),35618,18152,51,18152,51,0,587
인천공항T2(1)번출입구(3층),35614,6889,30670,6888,30670,1,1211
인천공항T2(6)B(1층),35619,4990,165,4990,165,0,166
인천공항T2(8)번출입구(3층),35615,8494,6795,8492,6795,2,493
인천공항T2-3층,35611,28,34,28,34,0,2
인천공항T2-B1층,35612,156,1,156,1,0,5
인천공항전망대,35365,1,54,1,54,0,1
인천공항전망대,35366,76,11,68,11,8,2
인천공항전망대(미정차),35630,4,1,4,1,0,0
인천공항충전소입구,35757,5,10,5,10,0,0
인천공항충전소입구,35758,40,2,40,2,0,1
인천과학예술영재학교,38579,136,118,135,118,1,8
인천과학예술영재학교,38580,41,455,41,455,0,16
인천광역시종합건설본부,37325,7108,6195,7106,6195,2,429
인천교(인천기계산업단지),37449,1268,808,1264,808,4,66
인천교(인천기계산업단지),37451,264,1405,258,1405,6,53
인천교삼거리,37453,1874,4236,1858,4236,16,197
인천교삼거리(인천기계산업단지),37452,1500,1185,1495,1185,5,86
인천교통공사,40032,38801,33766,38654,33766,147,2340
인천교회,38676,2853,6049,2845,6049,8,287
인천교회,39260,2884,3677,2874,3677,10,211
인천교회,39261,3326,2338,3305,2338,21,182
인천국민안전체험관,42233,84,424,84,424,0,16
인천국민안전체험관,42234,1064,913,1060,913,4,63
인천국제공항,35613,30,0,30,0,0,0
인천국제수산물타운,35815,16,1500,16,1500,0,48
인천국제수산물타운,35816,699,67,691,67,8,24
인천그랜드컨트리클럽,42954,128,522,128,522,0,20
인천그랜드컨트리클럽,42958,0,47,0,47,0,1
인천글로벌캠퍼스,39850,2025,2195,2025,2195,0,136
인천글로벌캠퍼스,39858,2016,1710,2016,1710,0,120
인천기계공고,37272,18895,6997,18890,6997,5,835
인천기계공고,37281,4259,12741,4259,12741,0,548
인천기계산업단지,37579,714,42,712,42,2,24
인천기계산업단지,37580,3,657,3,657,0,21
인천기독병원,35785,277,415,277,415,0,22
인천기독병원,35803,45,160,45,160,0,6
인천나비공원,40849,3680,2129,3627,2129,53,187
인천나비공원,40926,21,20,20,20,1,1
인천남동우체국,39630,7710,7788,7704,7788,6,499
인천노인전문병원,40878,3843,5927,3840,5927,3,315
인천논현역앞,39658,12872,16830,12864,16830,8,958
인천논현역앞,39659,15208,9838,15187,9838,21,807
인천논현중학교,92060,184,1503,181,1503,3,54
인천논현중학교,92061,399,123,395,123,4,16
인천논현중학교,92062,999,73,997,73,2,34
인천대검도수련원,43456,0,22,0,22,0,0
인천대검도수련원,43695,38,0,38,0,0,1
인천대공원,39471,2357,691,2355,691,2,98
인천대공원,39478,2754,5184,2740,5184,14,256
인천대공원역,39395,7691,1864,7670,1864,21,308
인천대공원역,39398,50,2169,49,2169,1,71
인천대공원후문(장수동),39442,4441,730,4381,730,60,166
인천대입구역,38395,50392,19188,50376,19188,16,2244
인천대입구역,38396,16760,52856,16734,52856,26,2245
인천대입구역.롯데몰,38646,5624,4004,5615,4004,9,310
인천대입구역.롯데몰,38649,2417,2691,2410,2691,7,164
인천대정문,38385,16529,565,16520,565,9,551
인천대정문,38386,969,15450,967,15450,2,529
인천대학교공과대학,38376,244,5745,244,5745,0,193
인천대학교공과대학,38377,19277,36,19230,36,47,623
인천대학교공과대학,38499,512,13622,463,13622,49,455
인천대학교북문,38760,3,924,3,924,0,29
인천대학교북문,38750,303,64,303,64,0,11
인천대학교송도캠퍼스,38749,18499,3049,18497,3049,2,695
인천대학교송도캠퍼스,38761,9,7413,9,7413,0,239
인천대학교자연과학대학,38375,160,12389,160,12389,0,404
인천대학교자연과학대학,38378,17389,98,17383,98,6,564
인천마전도서관,42556,8,880,8,880,0,28
인천미래생활고등학교,40470,4207,4656,4207,4656,0,285
인천미래생활고등학교,40474,5462,5510,5462,5510,0,353
인천미래생활고등학교,40483,818,2026,818,2026,0,91
인천미래생활고등학교,55032,2860,1351,2860,1351,0,135
인천박문초등학교,38608,373,106,373,106,0,15
인천박문초등학교,38609,112,431,111,431,1,17
인천보건고등학교,42144,2720,4601,2687,4601,33,236
인천보건고등학교,42146,5506,3942,5410,3942,96,304
인천부흥고등학교,40279,1573,738,1573,738,0,74
인천북항관공선부두,89195,31,1145,31,1145,0,37
인천북항관공선부두,89196,393,11,393,11,0,13
인천북항부두운영시설,42953,5,447,5,447,0,14
인천북항부두운영시설,42959,593,24,593,24,0,19
인천뷰티예술고등학교,38052,3209,4034,3179,4034,30,233
인천뷰티예술고등학교,38053,6455,2881,6452,2881,3,301
인천비즈니스고등학교,37421,3776,3551,3765,3551,11,236
인천비즈니스고등학교,37423,4806,5457,4791,5457,15,331
인천비즈니스고등학교,37614,7637,2461,7633,2461,4,325
인천비지니스고등학교,37615,385,2272,385,2272,0,85
인천상공회의소,92041,103,1,103,1,0,3
인천서곶초등학교,89355,427,1,421,1,6,13
인천서곶초등학교,89358,7,738,7,738,0,24
인천서부교육지원청,42336,1000,609,1000,609,0,51
인천서부교육지원청,42337,637,1637,637,1637,0,73
인천서부여성회관,42131,2413,1769,2385,1769,28,134
인천서부여성회관,42134,4211,5143,4153,5143,58,301
인천서창동우체국,39820,5309,9892,5303,9892,6,490
인천서창동우체국,39821,9721,2342,9709,2342,12,389
인천서창중학교,39767,5545,5639,5545,5639,0,360
인천서창중학교,39875,7678,2868,7678,2868,0,340
인천성모병원정문,40844,8413,8521,8384,8521,29,546
인천성모병원정문,40857,9191,7134,9163,7134,28,526
인천성모병원종점지주차장,40919,120,4423,114,4423,6,146
인천성모병원후문,40138,1883,7699,1858,7699,25,309
인천성모병원후문,40139,4775,2129,4748,2129,27,222
인천세관통합검사센터(동측),38774,0,1227,0,1227,0,39
인천세관통합검사센터(동측),38775,21,47,21,47,0,2
인천세관통합검사센터(서측),38772,66,344,64,344,2,13
인천세관통합검사센터(서측),38773,12,489,12,489,0,16
인천세무서후문,36179,13,257,13,257,0,8
인천소방본부,37189,5317,9425,5298,9425,19,475
인천소방본부,37191,13677,5533,13624,5533,53,619
인천소방항공대,35809,150,4,150,4,0,4
인천소방항공대,35810,16,239,16,239,0,8
인천송도꿈유치원,38622,3931,33,3931,33,0,127
인천송도꿈유치원,38623,8,5709,8,5709,0,184
인천송일초등학교,38558,662,1435,659,1435,3,67
인천송일초등학교,38575,1239,1508,1224,1508,15,88
인천수산물센터,35069,7266,7094,7168,7094,98,463
인천스타트업파크,38390,2495,873,2494,873,1,108
인천스타트업파크,38394,1077,3174,1076,3174,1,137
인천시청후문,39290,12202,8448,12179,8448,23,666
인천시청후문,39292,10480,12022,10429,12022,51,725
인천아시아드주경기장(동문),89354,1010,19,932,19,78,33
인천아시아드주경기장(동문),89359,96,1309,83,1309,13,45
인천아시아드테니스장,89356,449,23,441,23,8,15
인천아시아드테니스장,89357,13,803,10,803,3,26
인천여객터미널,89155,2,238,2,238,0,7
인천여자고등학교,38287,6960,7877,6960,7877,0,478
인천여자고등학교,38289,4238,4009,4238,4009,0,266
인천여자상업고등학교,35139,363,2457,362,2457,1,90
인천여자상업고등학교·이마트,35141,8849,2677,8825,2677,24,371
인천역(차이나타운),35178,25191,22651,25133,22651,58,1543
인천역(차이나타운),35179,24929,24260,24869,24260,60,1586
인천연세병원,42310,2358,2570,2357,2570,1,158
인천연합의원,42601,2201,3862,2189,3862,12,195
인천영어마을,42454,9237,8431,9230,8431,7,569
인천영어마을,42697,10125,13864,10111,13864,14,773
인천영어마을.파라곤센트럴,89437,7070,1688,7058,1688,12,282
인천영어마을앞,89436,282,1123,209,1123,73,45
인천예림학교(인천성모병원),40819,4794,6062,4779,6062,15,350
인천예림학교(인천성모병원),40820,7143,3811,7136,3811,7,353
인천예술고등학교,39332,1052,650,1038,650,14,54
인천예술고등학교,39533,592,752,580,752,12,43
인천옹진농협본점,35555,6717,4203,6678,4203,39,352
인천옹진농협본점,35797,946,1981,943,1981,3,94
인천용학초등학교,37676,2597,22,2597,22,0,84
인천의료원,36093,577,4279,573,4279,4,156
인천의료원,36107,14419,8756,14384,8756,35,747
인천의료원,36108,8947,12171,8919,12171,28,681
인천의료원,37458,4472,842,4472,842,0,171
인천이음중학교,89456,2588,902,2588,902,0,112
인천이음초등학교,89399,2941,754,2941,754,0,119
인천이음초등학교,89400,2681,7606,2681,7606,0,331
인천인력개발원,39071,1499,857,1498,857,1,76
인천인력개발원,39072,584,1855,583,1855,1,78
인천재능대학교서문,36058,16553,24183,16503,24183,50,1314
인천재능대학교서문,36119,11352,11037,11313,11037,39,722
인천적십자병원(풍림아파트),38240,3466,4946,3461,4946,5,271
인천적십자병원(풍림아파트),38339,5592,4232,5562,4232,30,316
인천정보과학고등학교,35175,2385,3422,2385,3422,0,187
인천정보과학고등학교,35183,5150,2017,5111,2017,39,231
인천정보과학고등학교,35800,17,58,17,58,0,2
인천정보과학고등학교,36002,2511,4548,2495,4548,16,227
인천종합수산물센터,35074,3510,291,3433,291,77,122
인천준법지원센터·미추홀트루엘파크,37147,1053,394,1053,394,0,46
인천준법지원센터·미추홀트루엘파크,37148,211,1105,211,1105,0,42
인천지방법원,37096,4011,67,3943,67,68,131
인천지방법원북부지원입구,89434,1094,854,1094,854,0,62
인천지방법원북부지원입구,89435,84,2104,84,2104,0,70
인천지방중소기업청입구,39087,2667,965,2665,965,2,117
인천체육고등학교,89233,196,336,196,336,0,17
인천체육고등학교입구,89048,27,26,27,26,0,1
인천체육고등학교입구,89049,7,75,7,75,0,2
인천축구전용경기장,36184,60,6,60,6,0,2
인천축구전용경기장,37286,2418,2377,2407,2377,11,154
인천축구전용경기장,37303,3491,1717,3481,1717,10,168
인천축구전용경기장(홈플러스),37558,452,2344,451,2344,1,90
인천축산농협,40454,474,822,461,822,13,41
인천축산물시장,42010,1498,1032,1489,1032,9,81
인천축산물시장,42011,730,1404,730,1404,0,68
인천출입국·외국인청,35127,14076,1632,14045,1632,31,506
인천출입국·외국인청,35129,1027,12030,1010,12030,17,421
인천터미널,37215,1673,20,1673,20,0,54
인천터미널사거리입구,39194,1338,5405,1338,5405,0,217
인천터미널역,37648,612,32,605,32,7,20
인천테크노밸리U1센터,40605,6634,8835,6630,8835,4,499
인천테크노밸리U1센터,40607,10823,6446,10820,6446,3,557
인천포스코고등학교,38758,4,840,4,840,0,27
인천포스코고등학교,38759,454,5,454,5,0,14
인천푸른빛유치원,89376,1522,99,1522,99,0,52
인천푸른빛유치원,89377,236,1578,236,1578,0,58
인천항신국제여객터미널,38652,1329,621,1321,621,8,62
인천항신국제여객터미널(하행),38662,832,1226,832,1226,0,66
인천해든초등학교,89410,4183,2756,4183,2756,0,223
인천해든초등학교,89411,4324,4070,4324,4070,0,270
인천해양과학고,38120,1963,1229,1963,1229,0,102
인천해양과학고,38566,492,548,491,548,1,33
인천향교.인천도호부청사,37124,3778,11415,3769,11415,9,490
인천향교.인천도호부청사,37125,7959,1444,7900,1444,59,303
인천향교유림회관,37059,12812,4238,12795,4238,17,550
인천향교유림회관,37062,8437,13564,8422,13564,15,709
인천환경공단입구,42930,436,89,436,89,0,16
인천힘찬종합병원,39628,6023,4497,6018,4497,5,339
인천힘찬종합병원,39629,4739,4890,4730,4890,9,310
인평자동차고,40149,14975,18610,14930,18610,45,1083
인평자동차고,40151,1081,713,1081,713,0,57
인평자동차고,40152,357,912,357,912,0,40
인평자동차고,40787,18626,11567,18604,11567,22,973
인하국제의료센터,35643,0,6,0,6,0,0
인하대병원,35119,13345,9415,13287,9415,58,734
인하대병원,35121,4169,1664,4157,1664,12,188
인하대병원,35486,6240,6741,6240,6741,0,418
인하대병원입구,35846,6653,13339,6601,13339,52,644
인하대역,37596,10,8412,10,8412,0,271
인하대역(1번출구),37066,73460,73549,73366,73549,94,4742
인하대역(7번출구),37091,100922,70745,100853,70745,69,5537
인하대역3번출구,37127,3688,18877,3677,18877,11,727
인하대역4번출구,37122,13375,5157,13368,5157,7,597
인하대정문,37099,13222,7176,13198,7176,24,658
인하대정문,37104,6673,15386,6654,15386,19,711
인하대후문,37165,42907,4480,42907,4480,0,1528
인하대후문,37166,765,1391,765,1391,0,69
인하대후문,37167,11514,46057,11505,46057,9,1857
인향아파트,40557,7563,491,7514,491,49,259
인향아파트,40559,474,6091,472,6091,2,211
인향아파트,41464,2635,99,2619,99,16,88
인향아파트,41465,86,5893,24,5893,62,192
인혜학교후문(원욱그린타운),41473,1269,656,1268,656,1,62
인혜학교후문(원욱그린타운),41518,596,2839,595,2839,1,110
인화1리마을회관,90210,7,7,7,7,0,0
인화1리마을회관,90211,18,10,18,10,0,0
인화리종점,43473,51,28,47,28,4,2
인화성입구,90063,1,18,1,18,0,0
인화성입구,90064,8,1,7,1,1,0
인화여고,37547,4187,4360,4175,4360,12,275
인화여고,37548,8738,12230,8728,12230,10,676
일신동행정복지센터,40200,6477,3561,6452,3561,25,323
일신동행정복지센터,40205,84,1938,83,1938,1,65
일신동행정복지센터,40220,2477,2742,2467,2742,10,168
일신시장,40207,3769,5008,3759,5008,10,283
일신시장,40210,4499,2358,4479,2358,20,221
일신주공,40866,477,1009,476,1009,1,47
일신주공109동,40868,6045,3851,6030,3851,15,319
임광그대가.서창자이아파트,39514,3156,1612,3155,1612,1,153
임광그대가.서창자이아파트,39515,278,3611,277,3611,1,125
임광그대가103동,92025,3535,3404,3529,3404,6,223
임송촌,43423,5,4,5,4,0,0
임송촌,43802,85,104,84,104,1,6
임학사거리,41283,532,1961,525,1961,7,80
임학역,41290,14598,21748,14563,21748,35,1172
임학역,41292,23272,13546,23226,13546,46,1187
임학지하차도앞사거리,41287,23,3260,23,3260,0,105
임학지하차도앞사거리,41288,2379,18,2379,18,0,77
입구지,35300,24,7,24,7,0,1
입구지,35751,1,30,1,30,0,1
입구지입구,35477,35,58,31,58,4,3
입구지입구,35478,56,3,52,3,4,1
자동차매매단지,11020,313,632,313,632,0,30
자동차매매단지,11021,526,296,526,296,0,26
자동차매매단지,36094,276,4964,271,4964,5,169
자동차매매단지,37459,3772,342,3769,342,3,132
자연사박물관,43451,4,1,4,1,0,0
자연사박물관,43667,0,12,0,12,0,0
자이금호힐스테이트,42849,358,4713,357,4713,1,163
자이금호힐스테이트,42850,3711,416,3696,416,15,133
자이더테라스1단지,89297,1199,355,1199,355,0,50
자이더테라스1단지,89298,429,1117,428,1117,1,49
자이더테라스2단지,42864,1797,2884,1797,2884,0,151
자이더테라스2단지,42871,3121,1487,3121,1487,0,148
자이더테라스2단지(209동),89460,468,832,465,832,3,41
자이더테라스2단지(209동),89495,71,502,69,502,2,18
작은구월사거리,39239,5203,5784,5200,5784,3,354
작은구월사거리,39240,6315,6085,6304,6085,11,400
작전1동주민센터,41113,15560,8845,15541,8845,19,787
작전동삼성홈플러스,41044,16235,28636,16163,28636,72,1447
작전동삼성홈플러스,41050,19217,8924,19087,8924,130,907
작전동풍림아파트,41090,200,1073,200,1073,0,41
작전서운동행정복지센터,41103,421,2651,421,2651,0,99
작전서운동행정복지센터,41104,2912,442,2900,442,12,108
작전역,41561,7246,6356,7246,6356,0,438
작전역,41562,7079,7215,7079,7215,0,461
작전역 서해그랑블,41047,2526,2489,2518,2489,8,161
작전역 서해그랑블,41414,1345,3228,1345,3228,0,147
작전역1번출구,41095,11266,15421,11253,15421,13,860
작전역2번출구,41092,5331,7083,5331,7083,0,400
작전역3번출구,41076,8902,4579,8896,4579,6,434
작전역4번출구,41062,14473,32178,14408,32178,65,1504
작전역5번출구,41057,58744,33489,58614,33489,130,2975
작전역6번출구,41433,4312,26730,4309,26730,3,1001
작전역7번출구,41401,20983,5000,20951,5000,32,838
작전역8번출구,41093,10900,9614,10889,9614,11,661
작전중고.여고앞,41116,3399,2887,3374,2887,25,202
작전초등학교,41127,3096,2724,3071,2724,25,187
작전초등학교,41128,2845,2482,2793,2482,52,171
작전풍림아파트,41080,1056,5869,1055,5869,1,223
작전풍림아파트,41091,7679,3024,7655,3024,24,345
잔다리삼거리,35519,53,49,52,49,1,3
잔다리삼거리,35559,70,44,70,44,0,3
잔다리삼거리,35856,7,22,7,22,0,0
잔다리삼거리,35857,26,3,25,3,1,0
잔다리새마을,35866,17,73,17,73,0,2
잔다리새마을,35867,47,105,47,105,0,4
잔솔밭,43943,42,28,42,28,0,2
잔솔밭,43944,11,14,11,14,0,0
잠진도삼거리,35743,40,2,40,2,0,1
잠진도삼거리,35744,6,90,6,90,0,3
잠진도입구,35749,5,63,5,63,0,2
잠진도입구,35750,28,23,28,23,0,1
장경리공영주차장,44141,1,22,1,22,0,0
장경리공영주차장,44190,41,0,41,0,0,1
장경리해수욕장,44092,12,22,10,22,2,1
장경리해수욕장,44191,12,6,8,6,4,0
장곡.고촌고등학교,80066,353,234,353,234,0,18
장곡.고촌고등학교,80288,21,33,21,33,0,1
장곶돈대,43931,38,6,37,6,1,1
장곶돈대,43932,31,54,30,54,1,2
장곶횟집,43118,10,2,10,2,0,0
장곶횟집,43478,4,6,3,6,1,0
장구란,90349,0,4,0,4,0,0
장구란,90354,2,0,2,0,0,0
장기동,41345,717,240,717,240,0,30
장기동,41346,268,3160,268,3160,0,110
장기동,41347,2590,13812,2590,13812,0,529
장기동,41348,18202,3138,18158,3138,44,688
장도초등학교,39127,439,558,439,558,0,32
장도초등학교,39129,2114,855,2114,855,0,95
장릉입구,80046,29,220,29,220,0,8
장릉입구,80047,238,7,238,7,0,7
장미아파트,37044,6498,8654,6494,8654,4,488
장미아파트,37092,14236,8598,14168,8598,68,736
장미아파트,37094,8491,9323,8466,9323,25,574
장미아파트(19동)앞,37474,2060,2292,2055,2292,5,140
장미아파트(19동)앞,37540,2032,2636,2019,2636,13,150
장서초등학교,39965,4064,695,4059,695,5,153
장서초등학교,39966,1062,5618,1062,5618,0,215
장수.서창동행정복지센터,39580,4544,8535,4538,8535,6,421
장수.서창동행정복지센터,39581,8552,1978,8546,1978,6,339
장수공영차고지,39566,3092,1444,2964,1444,128,146
장수공영차고지,92064,297,149,51,149,246,14
장수교,39336,432,566,432,566,0,32
장수교(서창동입구),39337,235,1042,235,1042,0,41
장수동,39373,543,1426,542,1426,1,63
장수동,39391,834,754,832,754,2,51
장수동,39393,2751,4469,2749,4469,2,232
장수빌라,39577,466,1078,466,1078,0,49
장수사거리,39389,11029,2781,11011,2781,18,445
장수사거리,39397,205,2493,205,2493,0,87
장수사거리,39501,2241,7068,2233,7068,8,300
장수사거리,39542,5006,385,4985,385,21,173
장수주공(청소년수련원),39417,50,1996,50,1996,0,66
장수주공(청소년수련원),39424,3271,54,3255,54,16,107
장수초등학교,39342,2638,1576,2604,1576,34,135
장수초등학교,39352,967,2183,959,2183,8,101
장수파출소,39543,14,689,14,689,0,22
장승마루,90028,1,14,1,14,0,0
장승마루,90029,16,1,16,1,0,0
장승마을,43200,1,37,0,37,1,1
장승마을,43714,66,0,51,0,15,2
장승백이시장,39280,3954,1487,3905,1487,49,175
장승백이시장,39282,606,4002,604,4002,2,148
장아초등학교,39873,987,632,976,632,11,52
장아초등학교,39874,171,1702,164,1702,7,60
장안,43418,10,31,9,31,1,1
장안,43445,56,15,50,15,6,2
장안마을,43133,8,1,8,1,0,0
장안마을,43855,2,9,2,9,0,0
장안말(구초지분교)입구,90083,87,129,87,129,0,6
장안말(구초지분교)입구,90084,131,114,131,114,0,7
장안말(온천스파),43144,29,14,29,14,0,1
장안말(온천스파),43253,20,7,15,7,5,0
장안말(온천스파),43892,7,10,7,10,0,0
장안사거리,37285,16174,3832,16152,3832,22,645
장안사거리,37295,4694,18693,4677,18693,17,754
장안촌동쪽,43933,3,38,3,38,0,1
장암마을,90155,83,85,83,85,0,5
장암마을,90156,34,18,34,18,0,1
장애인복지관,37249,2492,2612,2477,2612,15,164
장애인종합복지관,43627,3,9,3,9,0,0
장인가구,39706,257,215,257,215,0,15
장자말,43142,22,60,22,60,0,2
장자말,43257,50,0,47,0,3,1
장자촌,43141,20,1,19,1,1,0
장자촌,43255,1,1,1,1,0,0
장전,43415,34,6,33,6,1,1
장전,43500,1,11,1,11,0,0
장정2리마을회관,43665,0,72,0,72,0,2
장정2리마을회관,43693,117,1,116,1,1,3
장지포,90238,0,13,0,13,0,0
장지포,90239,17,1,17,1,0,0
장천사거리,37282,1974,2368,1974,2368,0,140
장천사거리,37610,244,1082,244,1082,0,42
장천사거리,37651,411,1311,411,1311,0,55
장촌길 입구,90379,11,6,11,6,0,0
장촌길 입구,90382,4,6,4,6,0,0
장촌마을,35475,200,19,198,19,2,7
장촌마을,35476,10,182,10,182,0,6
장촌빌라,35321,196,18,195,18,1,6
장촌빌라,35397,3,147,3,147,0,4
장하,43184,2,23,2,23,0,0
장하,43204,47,2,46,2,1,1
장화교회앞,43121,22,31,20,31,2,1
장화교회앞,43539,54,20,47,20,7,2
장화리학생수련원,43426,56,53,55,53,1,3
장화리학생수련원,43474,13,17,12,17,1,0
장흥낚시터,43211,17,3,16,3,1,0
장흥낚시터,43890,2,2,2,2,0,0
장흥리종점,43643,16,26,15,26,1,1
장흥리종점,43888,6,15,6,15,0,0
장흥매점,43641,2,5,2,5,0,0
장흥매점,43891,2,5,2,5,0,0
장흥삼거리,43153,68,16,68,16,0,2
장흥삼거리,43881,9,49,8,49,1,1
장흥저수지(성공회.해든뮤지움),90081,209,157,209,157,0,11
장흥저수지(성공회.해든뮤지움),90082,48,188,48,188,0,7
재능대·한국외대 송도캠퍼스,38754,59,0,59,0,0,1
재능대·한국외대 송도캠퍼스,38755,16,1346,16,1346,0,43
재활용품수집장,43165,3,9,3,9,0,0
저수지관리소,43264,24,0,23,0,1,0
저수지휴게소,43567,15,45,15,45,0,1
저수지휴게소,43763,0,1,0,1,0,0
적두마을(월곳교회),43190,20,0,19,0,1,0
적두마을(월곳교회),43709,0,32,0,32,0,1
적석사입구,43348,25,51,24,51,1,2
적석사입구,43847,82,2,74,2,8,2
전동교회,35199,7711,4500,7660,4500,51,393
전동교회,35200,2337,8055,2328,8055,9,335
전득이고개입구,90187,5,11,4,11,1,0
전득이고개입구,90188,9,32,8,32,1,1
전들,43477,42,3,42,3,0,1
전들,43835,1,57,1,57,0,1
전등사남문,43515,96,283,78,283,18,12
전등사남문,43893,220,81,220,81,0,9
전등사동문,43521,133,708,131,708,2,27
전등사동문,43895,494,270,491,270,3,24
전소,35231,6394,4449,6387,4449,7,349
전소,35232,5872,5731,5870,5731,2,374
전원미술관앞,43387,203,10,201,10,2,6
전원미술관앞,43810,5,250,5,250,0,8
전인연립(종점),40132,115,339,115,339,0,14
절아래,90401,3,13,3,13,0,0
절아래,90402,19,8,19,8,0,0
점촌,43414,40,1,26,1,14,1
점촌,43806,0,39,0,39,0,1
젓개마을,35828,1,92,1,92,0,3
젓개마을,35829,4,6,3,6,1,0
젓개마을입구,35322,1,3,1,3,0,0
젓개마을입구,35398,1,2,1,2,0,0
정광아파트(병무청),37008,4397,37,4381,37,16,143
정광아파트(병무청),37009,14,4747,12,4747,2,153
정광아파트.만수주공11단지,39476,7073,7394,7057,7394,16,466
정광아파트.만수주공11단지,39477,7566,4563,7550,4563,16,391
정기무역,35083,1477,177,1459,177,18,53
정다운그린빌,92024,1976,3229,1974,3229,2,167
정든마을아파트,40055,2325,4041,2314,4041,11,205
정든마을아파트,40057,4787,1987,4777,1987,10,218
정병원,40413,5145,4873,5144,4873,1,323
정부인천지방합동청사,37386,35026,16161,34995,16161,31,1651
정부인천지방합동청사,37388,26803,30281,26766,30281,37,1841
정비단지,37005,2178,1624,2178,1624,0,122
정비단지,37006,750,2138,750,2138,0,93
정서진삼거리,89234,4,414,4,414,0,13
정석항공과학고,37168,27189,6419,27180,6419,9,1084
정석항공과학고,37170,9949,24358,9942,24358,7,1106
정수사입구,43404,23,3,22,3,1,0
정수사입구,43436,12,23,12,23,0,1
정하,43183,31,0,31,0,0,1
정하,43208,3,14,3,14,0,0
제물포시장,37310,737,589,737,589,0,42
제물포시장,37311,833,919,833,919,0,56
제물포여자중학교,37288,3858,2127,3846,2127,12,193
제물포여자중학교,37290,5754,5242,5729,5242,25,354
제물포여자중학교,37298,7557,10611,7507,10611,50,586
제물포역,37355,57478,35725,57397,35725,81,3006
제물포역,37364,31786,21722,31740,21722,46,1726
제물포역,37496,34166,42724,34067,42724,99,2480
제물포역,37498,16894,5538,16894,5538,0,723
제물포역,37502,30879,40292,30850,40292,29,2295
제물포역(동양빌딩),37339,928,4816,928,4816,0,185
제물포중학교,42064,2201,2577,2171,2577,30,154
제물포중학교,42065,2740,1732,2725,1732,15,144
제운사거리(청년창업특화거리),37175,3604,5274,3593,5274,11,286
제운사거리(청년창업특화거리),37534,4827,6244,4815,6244,12,357
제일시장,37316,7167,6695,7167,6695,0,447
제일시장,37329,10683,11105,10656,11105,27,702
제일시장사거리,37667,1070,683,1070,683,0,56
제일주유소,57020,2417,1474,2417,1474,0,125
제일주유소,57021,1024,3535,1024,3535,0,147
제일풍경채,42833,3215,3649,3212,3649,3,221
제일풍경채1차정문앞,89350,1769,1396,1769,1396,0,102
제일풍경채2차,89349,25,309,25,309,0,10
제일풍경채2차321동앞,42866,3102,1152,3097,1152,5,137
제일풍경채2차321동앞,42873,306,1183,302,1183,4,48
제일풍경채2차323동앞,42891,6503,6282,6497,6282,6,412
제일풍경채2차331동앞,42989,1914,3493,1910,3493,4,174
제적봉앞마을,90060,0,1,0,1,0,0
제적봉앞마을,90061,0,1,0,1,0,0
제적봉입구,43654,0,19,0,19,0,0
제적봉입구,43686,2,0,2,0,0,0
조광교회입구,43533,5,0,5,0,0,0
조광교회입구,43868,0,26,0,26,0,0
조달청(한양2차아파트),37511,6635,14794,6597,14794,38,691
조달청비축기지,35114,1404,5290,1393,5290,11,215
조달청비축기지,35115,4039,1741,4028,1741,11,186
조동초등학교,39464,3011,1846,3011,1846,0,156
조동초등학교,39465,18,1287,18,1287,0,42
조리미입구,80068,1412,56,1412,56,0,47
조리미입구,80069,65,1445,65,1445,0,48
조바위,90350,0,15,0,15,0,0
조바위,90351,16,4,15,4,1,0
조산,43192,6,65,4,65,2,2
조산,43334,105,3,99,3,6,3
조산교회,43172,6,20,6,20,0,0
조산교회,43338,72,13,71,13,1,2
조산초등학교,43189,13,249,12,249,1,8
조산초등학교,43593,174,23,171,23,3,6
종갱이,43180,73,149,72,149,1,7
종갱이,43288,100,61,96,61,4,5
종근당,40002,279,14,279,14,0,9
종근당,40005,14,733,14,733,0,24
종근당.충정로역,11002,197,7759,197,7759,0,256
종로약국,57005,799,1173,799,1173,0,63
종로약국,57007,2263,889,2263,889,0,101
종생마을,80161,1042,211,1037,211,5,40
종생마을,80162,97,1372,96,1372,1,47
종점(병무청),37014,2358,23,2358,23,0,76
종합터미널,37242,45996,22772,45818,22772,178,2218
종합터미널,39177,14159,38692,14129,38692,30,1704
종현동정보화마을,62043,35,144,30,144,5,5
종현동정보화마을,62044,150,23,149,23,1,5
좌동교차로,89371,1,103,1,103,0,3
좌동마을,42452,154,61,154,61,0,6
좌동마을,89253,61,226,61,226,0,9
좌동마을입구,42456,37,112,37,112,0,4
좌동마을입구,42928,183,34,183,34,0,7
주거단지,35118,399,435,395,435,4,26
주거단지,35120,268,821,267,821,1,35
주공12단지,35082,881,204,881,204,0,35
주공12단지,35084,476,408,475,408,1,28
주공6단지후문,40453,4886,2825,4886,2825,0,248
주공뜨란채아파트,40708,3600,3234,3578,3234,22,220
주공뜨란채아파트,40803,3955,3137,3924,3137,31,228
주공아파트,40867,423,786,422,786,1,39
주물단지,42291,1211,3698,1211,3698,0,158
주안1동행정복지센터,37385,5089,7082,5084,7082,5,392
주안2동치안센터,37302,7136,4822,7135,4822,1,385
주안4동행정복지센터,37333,141,222,140,222,1,11
주안4동행정복지센터,37335,43,472,42,472,1,16
주안5동행정복지센터,37526,645,991,645,991,0,52
주안7동행정복지센터,37214,20300,20247,20227,20247,73,1307
주안7동행정복지센터,37216,23121,17281,23029,17281,92,1303
주안국가산단역,37583,6995,718,6995,718,0,248
주안국가산단역,37584,24,2179,24,2179,0,71
주안남초등학교,37283,7904,8428,7869,8428,35,526
주안남초등학교,37284,12257,4733,12224,4733,33,548
주안도서관,37341,541,364,539,364,2,29
주안도서관,37342,377,466,373,466,4,27
주안매매단지,37586,316,241,316,241,0,17
주안북부,37471,2075,9556,2073,9556,2,375
주안북부역,37418,19137,12609,19125,12609,12,1024
주안북부역,37420,16879,13031,16879,13031,0,964
주안북초등학교,37417,4453,7474,4452,7474,1,384
주안사거리,37330,17285,12009,17189,12009,96,944
주안사거리,37514,3110,9011,3110,9011,0,391
주안시범공단,39927,198,519,198,519,0,23
주안아파트,37207,741,2422,696,2422,45,102
주안아파트,37209,1346,1222,1308,1222,38,82
주안역,37387,86398,33154,86233,33154,165,3856
주안역,37389,19872,77367,19834,77367,38,3136
주안역,37402,816,3711,816,3711,0,146
주안역,37506,24858,17178,24753,17178,105,1356
주안역센트레빌아파트,37430,7854,9865,7845,9865,9,571
주안역센트레빌아파트정문,37490,810,983,810,983,0,57
주안역환승정류장,37503,90797,68909,90768,68909,29,5151
주안역환승정류장,37617,126115,103126,126115,103126,0,7394
주안파크자이더플래티넘아파트,37201,19968,10373,19860,10373,108,978
주안파크자이더플래티넘아파트,37204,9660,20115,9590,20115,70,960
주안현대아파트,37358,18461,16947,18391,16947,70,1142
주원고개,39377,1300,3756,1278,3756,22,163
주원고개,39396,3430,8632,3419,8632,11,389
주적골,39510,504,1847,491,1847,13,75
주적골,39608,475,912,471,912,4,44
주택마을,90230,3,94,3,94,0,3
중고등학교,44106,48,66,31,66,17,3
중고등학교,44193,101,40,85,40,16,4
중고차매매단지엠파크허브,42038,510,639,508,639,2,37
중곡고개,43935,7,1,7,1,0,0
중구노인복지회관,35151,12385,10510,12348,10510,37,738
중구노인복지회관,35152,12524,11452,12482,11452,42,773
중구문화회관,35466,2,686,2,686,0,22
중구문화회관,35467,1693,314,1684,314,9,64
중구청,35157,2913,1599,2902,1599,11,145
중구청,35159,852,3796,849,3796,3,149
중구청소년수련관.하늘중학교,35824,3156,895,3152,895,4,130
중독고개,43936,18,18,14,18,4,1
중박골입구,44123,14,8,14,8,0,0
중박골입구,44194,39,0,31,0,8,1
중봉로교차로,89420,1746,2380,1740,2380,6,133
중봉로교차로,89421,1134,681,1132,681,2,58
중부고용노동청(인천고용센터),39222,638,635,638,635,0,41
중부고용노동청(인천고용센터),39223,529,474,526,474,3,32
중산고등학교,35868,432,466,432,466,0,28
중산고등학교,35869,953,1046,953,1046,0,64
중산교차로,35652,868,549,868,549,0,45
중산교차로,35653,500,2907,500,2907,0,109
중산동,35305,1779,605,1779,605,0,76
중산동(까치빌라앞),35247,418,706,418,706,0,36
중산동(중촌),35272,631,1329,631,1329,0,63
중산동(중촌),35278,16,264,16,264,0,9
중산중고등학교,35817,232,253,232,253,0,15
중산중고등학교,35818,31,10,31,10,0,1
중산중학교,35656,1365,667,1365,667,0,65
중산중학교,35657,991,1404,990,1404,1,77
중앙공영아파트,41268,4242,1231,4242,1231,0,176
중앙공원사거리,39189,490,808,486,808,4,41
중앙방앗간,35852,3,31,3,31,0,1
중앙방앗간,35853,2,7,2,7,0,0
중앙사료,42014,2070,1493,2070,1493,0,114
중앙사료,42015,639,1140,639,1140,0,57
중앙산부인과,70176,11,287,11,287,0,9
중앙산부인과,70230,485,105,485,105,0,19
중앙시장,90125,1977,733,1887,733,90,87
중앙시장.고려궁지입구,43067,1065,1610,1048,1610,17,86
중앙아파트,40409,668,685,667,685,1,43
중앙아파트,42315,3260,2174,3258,2174,2,175
중앙하이츠,41110,4134,12167,4131,12167,3,525
중앙호수공원입구(호반베르디움),89245,32,617,32,617,0,20
중원고등학교,55078,2209,718,2205,718,4,94
중촌,43252,141,1,132,1,9,4
중촌,43369,0,49,0,49,0,1
중촌교차로,35436,145,596,145,596,0,23
중촌교차로,35443,1112,399,1110,399,2,48
중혈마을,43176,5,30,5,30,0,1
중혈마을,43299,48,2,48,2,0,1
중흥S클래스,42832,2727,1675,2724,1675,3,142
중흥S클래스,42847,680,438,680,438,0,36
중흥S클래스1차,42844,494,788,494,788,0,41
중흥S클래스1차,42845,702,577,702,577,0,41
중흥S클래스2차,42771,4812,1431,4797,1431,15,201
중흥S클래스2차,42856,4534,1074,4533,1074,1,180
중흥마을.은하마을,55070,384,323,384,323,0,22
지랏돌,90071,42,8,42,8,0,1
지랏돌,90072,0,12,0,12,0,0
지산리입구,43310,3,1,3,1,0,0
지산리입구,43751,5,5,5,5,0,0
지산입구(용진),43538,32,0,32,0,0,1
지산입구(용진),43679,0,15,0,15,0,0
지석리마을회관,90274,11,13,11,13,0,0
지석리오현부락,90275,31,33,31,33,0,2
지석초등학교입구,90277,28,10,28,10,0,1
지식정보단지역,38373,8566,1239,8566,1239,0,316
지식정보단지역,38403,7231,1213,7225,1213,6,272
지식정보단지역,38404,457,7009,457,7009,0,240
지식정보단지역(4번출구),38380,513,8913,513,8913,0,304
진고개(5연대입구),43380,201,132,197,132,4,10
진고개(5연대입구),43794,27,172,27,172,0,6
진광횟집앞,43507,36,8,33,8,3,1
진광횟집앞,43541,11,13,10,13,1,0
진달래아파트,37600,5,762,5,762,0,24
진두방앗간,44129,0,36,0,36,0,1
진두방앗간,44195,15,0,15,0,0,0
진두방앗간,44196,2,0,2,0,0,0
진산과학고등학교,40640,6,394,3,394,3,12
진산과학고등학교,40915,116,4,116,4,0,3
진산중학교,40575,1005,2482,999,2482,6,112
진산초등학교,40614,921,3630,920,3630,1,146
진산초등학교,40633,4,169,4,169,0,5
진산초등학교,40914,266,35,248,35,18,9
진솔인더스트리,89447,343,7,343,7,0,11
진솔인더스트리,89448,0,301,0,301,0,9
진웅종점,42803,13,1215,5,1215,8,39
진웅종점,42804,2123,28,2094,28,29,69
진주5단지503동앞,42089,3519,3061,3509,3061,10,212
진주상가,42544,3546,300,3518,300,28,124
진주아파트2단지,42092,361,11556,352,11556,9,384
진주아파트2단지6동,42084,83,6833,83,6833,0,223
진주아파트3단지,42086,9220,226,9189,226,31,304
진주아파트4단지,42077,3889,171,3877,171,12,130
진표에너지,42548,3,276,2,276,1,9
진흥아파트,37190,3146,2386,3099,2386,47,178
진흥아파트,37193,2387,3448,2366,3448,21,188
진흥아파트,37240,5952,4304,5943,4304,9,330
진흥아파트,37243,6221,10501,6206,10501,15,539
진흥아파트,39297,7503,7358,7503,7358,0,479
집단에너지,39064,218,167,218,167,0,12
집단에너지시설,39065,90,199,90,199,0,9
짓절미,43485,17,20,16,20,1,1
짓절미,43713,5,7,5,7,0,0
찬우물,39179,1078,3032,1078,3032,0,132
찬우물,39188,1544,802,1541,802,3,75
찬우물,43048,128,270,123,270,5,12
찬우물약수터,43851,117,265,114,265,3,12
참빛감리교회,42437,16250,10855,16225,10855,25,874
참좋은집,36160,380,5,378,5,2,12
참좋은집,36161,20,435,20,435,0,14
창골,43549,216,89,209,89,7,9
창리,43052,286,283,281,283,5,18
창리,43053,320,317,313,317,7,20
창리,43054,405,349,396,349,9,24
창리,43902,20,48,19,48,1,2
창리,43903,6,2,6,2,0,0
창신초등학교,42620,3247,2963,3242,2963,5,200
창신초등학교,42621,4230,4434,4224,4434,6,279
창후1리마을회관,43595,182,0,176,0,6,5
창후1리마을회관,43783,1,204,1,204,0,6
창후리입구,43604,145,8,136,8,9,4
창후리입구,43830,79,211,75,211,4,9
창후리종점,43774,24,67,24,67,0,2
창후정미소,43461,68,6,65,6,3,2
창후정미소,43600,11,53,11,53,0,2
채석장,38179,1098,440,1098,440,0,49
채플 갤러리,90423,0,9,0,9,0,0
천곡,43409,139,3,135,3,4,4
천곡,43827,6,161,6,161,0,5
천촌,43411,4,95,4,95,0,3
천촌,43795,119,0,117,0,2,3
철곶,43653,6,13,2,13,4,0
철곶,43759,13,3,11,3,2,0
철산리검문소,43957,5,21,5,21,0,0
철산리검문소,43958,32,6,32,6,0,1
철산리입구,43685,18,22,18,22,0,1
철산리입구,43741,2,35,2,35,0,1
첨단초등학교,92014,424,4057,424,4057,0,144
청광플러스원101동앞,92070,327,3249,327,3249,0,115
청광플러스원102동앞,39946,832,111,832,111,0,30
청광플러스원아파트,39775,5800,3260,5798,3260,2,292
청광플러스원아파트,39786,2697,7417,2696,7417,1,326
청능로사거리,39622,41634,17995,41553,17995,81,1923
청능로사거리,39623,20195,40394,20124,40394,71,1954
청라1동행정복지센터,42744,13895,5544,13895,5544,0,627
청라1동행정복지센터,42745,7308,10139,7308,10139,0,562
청라1호문화공원,89470,2,0,2,0,0,0
청라1호문화공원,89471,8,0,8,0,0,0
청라2동행정복지센터,89039,2965,738,2965,738,0,119
청라2동행정복지센터,89042,1426,3211,1426,3211,0,149
청라3동행정복지센터,89374,1445,5994,1445,5994,0,239
청라3동행정복지센터,89375,7248,1149,7248,1149,0,270
청라BRT차고지입구,89336,15,686,6,686,9,22
청라BRT차고지입구,89337,712,53,691,53,21,24
청라고등학교,42784,2520,1112,2520,1112,0,117
청라고등학교,42785,1347,2529,1347,2529,0,125
청라골프아카데미,89255,117,59,117,59,0,5
청라골프아카데미,89256,76,153,76,153,0,7
청라국제도서관,42922,29,294,29,294,0,10
청라국제도서관,42923,401,91,401,91,0,15
청라국제도시역,89270,56017,658,56017,658,0,1828
청라국제도시역(1번출구),89043,27381,34499,27347,34499,34,1996
청라국제도시역(경명대로),89034,7744,8736,7736,8736,8,531
청라국제도시역(영종방향),89215,31107,26292,31100,26292,7,1851
청라국제어린이집,89289,319,54,319,54,0,12
청라국제업무단지(골드클래스),42984,820,552,820,552,0,44
청라꽃농원,42991,74,80,71,80,3,4
청라달튼국제학교,42895,796,471,793,471,3,40
청라달튼국제학교,89121,724,801,724,801,0,49
청라도,42931,13,120,13,120,0,4
청라도,89127,6,34,6,34,0,1
청라디이스트,42961,71,1194,67,1194,4,40
청라디이스트(562동),42962,1737,3796,1736,3796,1,178
청라디이스트(567동),89017,946,154,944,154,2,35
청라로데오시티포레안,89419,114,337,114,337,0,14
청라로봇랜드,89246,29,10,28,10,1,1
청라로봇랜드,89247,0,80,0,80,0,2
청라모아미래도,89353,32,70,32,70,0,3
청라문학공원,89480,60,27,60,27,0,2
청라백세요양병원,42944,114,61,113,61,1,5
청라백세요양병원,89179,129,151,128,151,1,9
청라복합문화센터,89218,222,1699,222,1699,0,61
청라복합문화센터,89219,1224,282,1224,282,0,48
청라센텀로제비앙,89295,1302,1205,1302,1205,0,80
청라센텀로제비앙,89296,1364,1414,1363,1414,1,89
청라센텀로제비앙정문앞,89346,40,35,40,35,0,2
청라센트럴에일린의뜰,42834,4641,4086,4636,4086,5,281
청라센트럴에일린의뜰104동,42990,4003,1665,4001,1665,2,182
청라센트럴에일린의뜰106동,42892,9888,5533,9874,5533,14,497
청라스타필드,89417,226,306,225,306,1,17
청라스타필드,89418,361,649,361,649,0,32
청라시티프라디움,89334,1594,2057,1594,2057,0,117
청라시티프라디움,89335,2960,1042,2959,1042,1,129
청라우미린,42862,626,4532,625,4532,1,166
청라우미린아파트,89290,3162,11019,3162,11019,0,457
청라웰카운티221동,89288,60,424,60,424,0,15
청라웰카운티223동,42997,1031,239,1031,239,0,40
청라자이,42742,10876,3086,10860,3086,16,450
청라중앙호수공원입구,89021,13038,10210,13038,10210,0,749
청라중앙호수공원입구,89024,8633,13972,8633,13972,0,729
청라중학교,42848,875,1981,875,1981,0,92
청라초등학교,89281,6166,7389,6166,7389,0,437
청라초등학교,89282,5216,6746,5216,6746,0,385
청라파크자이상가,89299,718,921,713,921,5,52
청라파크자이상가,89300,585,642,585,642,0,39
청라푸르지오,89217,837,1277,837,1277,0,68
청라푸르지오라피아노,89497,13,35,13,35,0,1
청라푸르지오라피아노,89498,17,33,17,33,0,1
청라한양수자인레이크블루,89348,2447,1963,2447,1963,0,142
청라한양수자인레이크블루,89351,2345,1375,2345,1375,0,120
청라한화꿈에그린,89123,1466,612,1466,612,0,67
청라한화꿈에그린,89124,546,953,546,953,0,48
청라호반베르디움.포리공원,42899,2048,478,2048,478,0,81
청라호반베르디움.포리공원,42919,737,1941,737,1941,0,86
청라호수공원(남측),42861,2498,975,2498,975,0,112
청라호수공원(남측),42863,935,2533,935,2533,0,111
청라호수공원한신더휴,42870,7154,1014,7119,1014,35,263
청라호수공원한신더휴아파트,89291,15427,6256,15427,6256,0,699
청라힐스테이트,42987,1048,2947,1048,2947,0,128
청라힐스테이트,42988,3123,658,3116,658,7,121
청람중학교,89018,1626,1992,1624,1992,2,116
청람중학교,89019,2393,2142,2393,2142,0,146
청람초등학교,89279,6786,10157,6786,10157,0,546
청람초등학교,89280,10039,8389,10039,8389,0,594
청량중학교,38086,11147,4735,11103,4735,44,512
청련사입구,43766,47,155,46,155,1,6
청련사입구,43841,153,1,153,1,0,4
청룡정,41633,64,10,64,10,0,2
청룡정,41634,1,150,1,150,0,4
청소년수련관,42612,2791,54,2786,54,5,91
청소년수련관,42613,29,2818,27,2818,2,91
청소년수련관,43078,72,7,70,7,2,2
청소년수련관,43079,13,15,13,15,0,0
청소년수련관.어린이과학관,41307,11837,8788,11779,8788,58,665
청소년수련관.어린이과학관,41308,6709,8886,6676,8886,33,503
청송1단지.중흥S클래스,80090,183,223,180,223,3,13
청송1단지.중흥S클래스,80102,595,238,595,238,0,26
청송2.3단지,80089,71,136,71,136,0,6
청송2.3단지,80101,370,85,370,85,0,14
청송마을.성우오스타,80329,146,98,146,98,0,7
청송부락,90092,1,8,1,8,0,0
청양골,42775,1,86,1,86,0,2
청운대삼거리(하늘꿈교회),37433,5213,4523,5183,4523,30,314
청운대삼거리(하늘꿈교회),37500,2918,3324,2902,3324,16,201
청운대후문.한전제물포지사,37632,389,963,389,963,0,43
청운대후문.한전제물포지사,37633,152,1233,152,1233,0,44
청정주말농장,39852,1,91,1,91,0,2
청천농장,40538,139,1546,139,1546,0,54
청천농장,42511,1335,276,1331,276,4,51
청천농장(종점),40520,3173,18,3124,18,49,102
청천농장입구,40558,462,170,452,170,10,20
청천농장입구,40809,4,451,4,451,0,14
청천도서관,40426,1049,1844,1049,1844,0,93
청천도서관,40427,886,851,886,851,0,56
청천동,40808,661,7,661,7,0,21
청천동무지개아파트,40617,886,3901,881,3901,5,154
청천동무지개아파트,40618,3138,930,3129,930,9,131
청천동차고지,40925,339,321,289,321,50,21
청천중학교,40449,4500,3673,4483,3673,17,263
청천중학교,40455,1527,3172,1509,3172,18,151
청천천공영주차장,40896,277,1554,277,1554,0,59
청천천공영주차장,41639,413,1452,413,1452,0,60
청천초등학교,40582,3556,5814,3539,5814,17,302
청천초등학교,40586,20320,7583,20208,7583,112,900
청천초등학교,40587,3913,13237,3894,13237,19,553
청천초등학교후문,40574,1496,13473,1483,13473,13,482
청천초등학교후문,40579,13543,1414,13445,1414,98,482
청천치안센터,40533,28944,14597,28801,14597,143,1404
청천치안센터,40537,9182,12615,9159,12615,23,703
청천푸르지오아파트,40488,11100,137,11015,137,85,362
청천푸르지오아파트,40515,12047,1573,12033,1573,14,439
청천푸르지오아파트,40516,1574,8684,1574,8684,0,330
청천푸르지오아파트,40811,7548,1612,7546,1612,2,295
청천푸르지오아파트,40812,744,4748,742,4748,2,177
청천푸르지오아파트,40894,16,2072,16,2072,0,67
청천하우스디아파트,40475,6044,1997,6029,1997,15,259
청천하우스디아파트,40477,633,4075,633,4075,0,151
청학동.한국전력남인천지사,38230,2943,3950,2928,3950,15,222
청학동.한국전력남인천지사,38239,8082,6529,8063,6529,19,471
청학사거리,38256,23112,14978,23107,14978,5,1228
청학사거리,38259,10044,14719,10033,14719,11,798
청학사거리,38509,1592,1720,1592,1720,0,106
청학아파트,38236,10291,6027,10267,6027,24,526
청학아파트,38341,6824,7686,6802,7686,22,468
청학중학교,38160,3855,5211,3855,5211,0,292
청학중학교,38161,3330,2266,3330,2266,0,180
청학중학교,38496,1101,540,1099,540,2,52
청학초등학교,38181,2864,3456,2863,3456,1,203
청학초등학교,38185,3185,2628,3184,2628,1,187
청학초등학교,38190,1846,2680,1840,2680,6,146
체육공원,90214,19,9,19,9,0,0
체육공원앞,35605,3,257,3,257,0,8
체육공원앞,35606,220,5,219,5,1,7
초은고등학교,89025,9692,7892,9692,7892,0,567
초은고등학교,89026,3931,10658,3931,10658,0,470
초정마을,41252,3697,2687,3697,2687,0,205
초정마을,41254,2356,1061,2356,1061,0,110
초지,43016,10,54,9,54,1,2
초지대교,43017,199,376,198,376,1,18
초지대교,43071,1371,374,1363,374,8,56
초지대교,43106,260,662,259,662,1,29
초지리,43026,76,177,70,177,6,8
초지리,43093,1,51,1,51,0,1
초지삼거리,43112,67,46,67,46,0,3
초지삼거리,43147,4,28,4,28,0,1
초지삼거리,43508,8,95,8,95,0,3
초지진,43024,17,65,17,65,0,2
초지진,43025,168,79,166,79,2,7
초지큰말,43260,38,0,25,0,13,1
초지큰말,43512,0,23,0,23,0,0
축현초등학교.인천시립박물관,38151,5370,3551,5364,3551,6,287
축현초등학교.인천시립박물관,38152,2817,5026,2797,5026,20,253
축협,43061,1233,876,1212,876,21,68
충렬사,43326,10,0,10,0,0,0
충렬사,43629,47,69,47,69,0,3
충성아파트,40117,813,1636,811,1636,2,79
충정로역2호선,22064,8879,92,8879,92,0,289
치마바위,43247,0,28,0,28,0,0
치마바위,43646,5,1,3,1,2,0
카페거리,35727,14,49,14,49,0,2
카페거리,35728,14,57,13,57,1,2
칼빈매니토바국제학교,38370,2359,4426,2359,4426,0,218
칼빈매니토바국제학교,38435,3042,488,3042,488,0,113
칼빈매니토바국제학교,38500,5202,2952,5174,2952,28,263
캐슬해모로,39845,1029,259,1029,259,0,41
캐슬해모로,39846,5346,565,5346,565,0,190
캐슬해모로,39848,511,844,511,844,0,43
캐슬해모로,39849,918,3954,918,3954,0,157
캠퍼스타운역,38419,9666,18766,9663,18766,3,917
캠퍼스타운역,38420,8908,6167,8907,6167,1,486
캠퍼스타운역(3번출구),38388,28,2495,27,2495,1,81
캠퍼스타운역(3번출구),38717,514,28,514,28,0,17
커넬워크,38415,900,412,900,412,0,42
커넬워크,38417,2580,1780,2567,1780,13,140
커넬워크,38753,78,2454,77,2454,1,81
커넬워크(4동),38527,585,1117,585,1117,0,54
컨벤시아,38372,1093,2604,1093,2604,0,119
코세스물류창고,89197,70,6,70,6,0,2
코스모스아파트,42098,342,1107,337,1107,5,46
코오롱더프라우,38439,36,908,36,908,0,30
코오롱아파트작전중.고.여고,41117,2772,3848,2731,3848,41,213
"쿠팡16,17센터",35865,377,698,376,698,1,34
쿠팡물류센터,89157,1,490,1,490,0,15
큐티엘,90218,16,7,16,7,0,0
큰말,43937,22,0,22,0,0,0
큰말,43938,0,27,0,27,0,0
큰말,43949,7,11,7,11,0,0
큰말,90309,7,4,7,4,0,0
큰무리선착장,35710,88,66,88,66,0,4
큰무리선착장,35712,8,234,8,234,0,7
큰방죽사거리,39144,2383,3152,2382,3152,1,178
큰방죽사거리,39145,1218,2625,1214,2625,4,123
큰방죽삼거리,39575,83,215,83,215,0,9
큰방죽삼거리,39576,54,419,54,419,0,15
큰산너머입구,44013,17,113,16,113,1,4
큰산너머입구,44014,115,15,113,15,2,4
킹스빌타운,41315,2674,2887,2665,2887,9,179
타운하우스공장.명진화학,89226,1,188,1,188,0,6
타운하우스공장.명진화학,89227,187,2,187,2,0,6
탄토 마을,90381,19,0,18,0,1,0
탄토마을,90378,15,27,15,27,0,1
탑재,43115,2,42,2,42,0,1
탑재,43327,272,241,272,241,0,16
탑재,43579,202,314,202,314,0,16
태경아파트,38275,8568,8799,8568,8799,0,560
태산.대진아파트,38294,2532,2604,2525,2604,7,165
태산아파트,41193,7623,10707,7615,10707,8,591
태산아파트,42227,584,454,582,454,2,33
태신보세창고,89236,69,250,67,250,2,10
태신보세창고,89237,880,69,876,69,4,30
태양공단,42147,2087,1565,2072,1565,15,117
태양공단,42148,2120,2106,2117,2106,3,136
태양주택,40204,13,1091,13,1091,0,35
태영아파트,42298,3655,3286,3650,3286,5,223
태영아파트,42300,3384,3415,3382,3415,2,219
태평1차아파트,39241,3757,400,3757,400,0,134
태평1차아파트,39242,289,3878,289,3878,0,134
태평1차아파트,39516,9520,1937,9509,1937,11,369
태평1차아파트,39517,2161,10323,2159,10323,2,402
태평2차아파트,39225,11903,4047,11894,4047,9,514
태평2차아파트,39518,3813,8435,3809,8435,4,395
태평아파트,38083,8356,7057,8337,7057,19,497
태평아파트,41183,1423,215,1399,215,24,52
태평아파트.주안한신휴플러스아파트,37180,2614,4296,2564,4296,50,222
태평아파트.주안한신휴플러스아파트,37183,1468,1915,1445,1915,23,109
태평아파트1차(A),42326,4674,11915,4673,11915,1,535
태평아파트1차(B),42325,11666,4263,11666,4263,0,513
태평아파트2차(A),42317,2440,3228,2440,3228,0,182
태평아파트2차(B),42318,5580,3128,5580,3128,0,280
태평아파트입구,39274,71,1489,69,1489,2,50
태평아파트입구,39276,341,220,340,220,1,18
태평양산업,39066,2567,648,2566,648,1,103
태평양인천물류센터,42012,1629,1969,1625,1969,4,116
태화.두진아파트,39441,8634,5852,8607,5852,27,467
태화두진아파트,39445,6317,6876,6301,6876,16,425
태화아파트,37413,4466,3656,4463,3656,3,262
태화아파트,37416,5376,4758,5373,4758,3,326
태화아파트,40545,8512,4049,8508,4049,4,405
태화아파트,40810,1782,56,1782,56,0,59
태화한진아파트,41132,4577,2734,4572,2734,5,235
태화한진아파트612동,41135,1199,2861,1199,2861,0,130
택리,43233,34,10,31,10,3,1
택리,43859,7,43,5,43,2,1
택리교회,43229,15,90,15,90,0,3
택리교회,43860,89,12,89,12,0,3
테니스장,40456,258,154,258,154,0,13
테일코리아,89430,263,107,263,107,0,11
테일코리아,89431,454,357,454,357,0,26
테크노파크IT센타,39726,931,3269,931,3269,0,135
테크노파크IT센타,39727,3504,2459,3504,2459,0,192
테크노파크IT센터,39938,2888,3970,2887,3970,1,221
테크노파크역,38421,30284,19632,30266,19632,18,1610
테크노파크역,38422,31350,25554,31349,25554,1,1835
토지금고,37114,8397,2435,8357,2435,40,349
토지금고,37115,3632,11157,3607,11157,25,477
토지금고시장,37102,18174,13314,18145,13314,29,1015
토지금고시장앞,37509,9038,10071,9034,10071,4,616
통진성당,80137,1412,374,1408,374,4,57
통진성당,80138,344,1410,340,1410,4,56
통진중고등학교,35073,3485,558,3454,558,31,130
통진중고등학교,35074,579,2884,570,2884,9,111
트러스(서구장애인직업재활시설),42809,342,2,342,2,0,11
트러스(서구장애인직업재활시설),42810,0,179,0,179,0,5
트레지움1단지.다니엘병원,55076,2459,903,2459,903,0,108
트레지움1단지.다니엘병원,55077,802,1777,802,1777,0,83
파라곤보타닉파크,89422,2944,43,2944,43,0,96
파라곤보타닉파크(고산터널),89395,10039,2509,10039,2509,0,404
파라다이스공원,43391,107,9,105,9,2,3
파라다이스공원,43828,5,136,5,136,0,4
파라다이스시티역,35748,0,14,0,14,0,0
팔도주유소,40175,291,346,291,346,0,20
팔도주유소,40774,11532,7137,11500,7137,32,602
팬더아파트,39968,464,5,463,5,1,15
팬더아파트,39980,0,364,0,364,0,11
펜션마을,90392,0,13,0,13,0,0
펜션마을,90393,9,0,9,0,0,0
평전,43258,0,57,0,57,0,1
평화전망대,43743,20,49,20,49,0,2
평화전망대,43760,29,4,29,4,0,1
포내교회,35874,25,2,25,2,0,0
포내교회,35875,0,26,0,26,0,0
포도마을,55039,2747,3054,2743,3054,4,187
포도마을사거리.현대백화점.이마트,55055,10863,9156,10854,9156,9,645
포도밭,43939,6,6,5,6,1,0
포도밭,43940,10,26,10,26,0,1
포레시안101동앞,39729,6169,5017,6168,5017,1,360
포레시안101동앞,39730,4551,4007,4551,4007,0,276
포스코타워앤쉐라톤호텔,38491,3128,1780,3125,1780,3,158
푸르지오더베뉴(3216동),89442,515,1911,515,1911,0,78
푸르지오더베뉴후문,89423,21,2902,21,2902,0,94
푸르지오더스카이,35844,4583,1971,4573,1971,10,211
푸르지오더스카이,35845,2219,2628,2214,2628,5,156
푸르지오더스카이256동,35508,393,28,393,28,0,13
푸르지오더스카이256동,35509,82,349,82,349,0,13
푸르지오월드마크,38471,8472,12768,8455,12768,17,685
푸르지오하버뷰,38456,213,570,213,570,0,25
푸르지오하버뷰,38522,1030,2517,1030,2517,0,114
푸른초장,90052,0,108,0,108,0,3
푸른초장,90053,88,6,86,6,2,3
풍류산,90129,0,8,0,8,0,0
풍류산,90130,28,0,25,0,3,0
풍림1단지정문,70007,3,926,3,926,0,29
풍림1차205동,35255,3148,4940,3148,4940,0,260
풍림1차205동,35256,8502,4431,8500,4431,2,417
풍림1차아파트,42970,4765,11675,4758,11675,7,530
풍림1차아파트,,12993,4461,12992,4461,1,563
풍림2.3차아파트,38350,10253,2440,10253,2440,0,409
풍림2단지,70010,13,1384,12,1384,1,45
풍림2차,42485,10527,69,10527,69,0,341
풍림2차아파트,38049,5417,14393,5410,14393,7,639
풍림2차아파트,38050,7470,5711,7424,5711,46,425
풍림3단지정문,70003,194,182,193,182,1,12
풍림3차아파트,42366,8573,5050,8572,5050,1,439
풍림6단지,35124,2610,696,2602,696,8,106
풍림아이원,36114,131,1210,130,1210,1,43
풍림아이원,36115,6841,1882,6836,1882,5,281
풍림아이원,36121,2563,9447,2563,9447,0,387
풍림아이원,41441,3865,2077,3854,2077,11,191
풍림아이원아파트,37034,18673,8771,18657,8771,16,885
풍림아파트,36122,6621,547,6598,547,23,231
풍림아파트,37245,24320,7038,24277,7038,43,1011
풍림아파트,37246,6039,13456,6030,13456,9,628
풍림아파트,38255,3439,6547,3437,6547,2,322
풍림아파트,39162,8140,11677,8121,11677,19,639
풍림아파트,39163,12971,6105,12926,6105,45,615
풍림아파트,41374,2711,2581,2708,2581,3,170
풍림아파트,70008,583,12,580,12,3,19
풍림아파트(소래마을),39120,1208,3294,1199,3294,9,145
풍림아파트104동,40898,7063,6242,7054,6242,9,429
풍림아파트104동,40899,5031,5404,5027,5404,4,336
풍림아파트상가,70043,258,371,257,371,1,20
풍림아파트상가,70044,387,117,374,117,13,16
풍림엑슬루타워,42830,7195,7650,7193,7650,2,478
풍무역,80167,425,4346,425,4346,0,153
풍무역,80168,3283,456,3283,456,0,120
풍물시장,35054,258,1134,249,1134,9,44
풍물시장,35055,221,13,219,13,2,7
풍물시장,43941,97,6690,92,6690,5,218
풍산빌라 입구,90384,1,15,1,15,0,0
풍산특수금속,90219,13,3,13,3,0,0
프라임,39643,4932,1332,4932,1332,0,202
프리상뜨아파트,40230,137,4056,137,4056,0,135
프린피아통합물류센터,89235,282,7,280,7,2,9
하나개삼거리,35733,5,28,5,28,0,1
하나개삼거리,35734,8,22,8,22,0,0
하나개해수욕장,35737,196,828,196,828,0,33
하나글로벌캠퍼스,89444,1332,506,1332,506,0,59
하나글로벌캠퍼스,89445,369,4373,369,4373,0,152
하나금융그룹통합데이터센터,89265,225,1799,225,1799,0,65
하나금융그룹통합데이터센터,89294,280,155,280,155,0,14
하나로쇼핑,37118,3513,8783,3465,8783,48,396
하나모터스,89451,385,2,384,2,1,12
하나모터스,89452,0,308,0,308,0,9
하나아파트,37052,9607,3286,9597,3286,10,415
하나아파트,40546,1118,1789,1118,1789,0,93
하나아파트,41250,5301,6377,5280,6377,21,376
하나아파트,41574,1510,9,1506,9,4,49
하나아파트101동,41578,1183,2143,1183,2143,0,107
하늘도시중심상가,35821,2169,487,2158,487,11,85
하늘도시중심상가,35822,480,2137,479,2137,1,84
하늘문화센터,35826,3,92,3,92,0,3
하늘문화센터,35827,50,3,50,3,0,1
하늘문화센터입구,35766,1,100,1,100,0,3
하늘문화센터입구,35767,21,4,21,4,0,0
하늘중학교,35823,859,1246,859,1246,0,67
하늘초등학교후문,35499,243,338,240,338,3,18
하늘초등학교후문,35500,215,951,215,951,0,37
하늘휴게소,70220,2310,6551,2310,6551,0,285
하늘휴게소,70221,6146,2369,6146,2369,0,274
하룩,43157,17,177,17,177,0,6
하룩,43281,212,36,202,36,10,8
하리마을회관,90243,0,7,0,7,0,0
하리마을회관,90244,10,0,10,0,0,0
하리선착장,90240,6,13,6,13,0,0
하야동,41438,317,468,315,468,2,25
하야동,41439,470,631,467,631,3,35
하얀마을,55035,2341,2476,2340,2476,1,155
하얀집민박,43440,11,1,10,1,1,0
하얀집민박,43497,13,28,13,28,0,1
하얏트호텔,35028,1436,10380,1431,10380,5,381
하얏트호텔,35206,3490,3134,3476,3134,14,213
하우고개,43275,37,97,36,97,1,4
하우고개,43577,108,68,105,68,3,5
하우스앞,43174,31,0,31,0,0,1
하우스앞,43231,0,20,0,20,0,0
하우스토리,41569,182,231,178,231,4,13
하우스토리,41570,133,1330,127,1330,6,47
하우스토리,41606,397,558,397,558,0,30
하우스토리,41626,696,364,696,364,0,34
하우스토리만수아파트,39301,1110,821,1098,821,12,62
하일부락입구,43967,7,2,7,2,0,0
하일부락입구,43971,0,7,0,7,0,0
하점공단,43448,7,63,6,63,1,2
하점공단,43755,34,5,29,5,5,1
하점면사무소,43738,235,124,227,124,8,11
하점면사무소,43834,113,192,106,192,7,9
하점순복음교회,90222,160,0,146,0,14,5
하점순복음교회,90223,0,48,0,48,0,1
하점우체국,43817,514,62,481,62,33,18
하점우체국,43838,94,591,92,591,2,22
하점초등학교,43739,2,106,2,106,0,3
하점초등학교,43836,130,5,123,5,7,4
하정초등학교,40044,1534,1009,1523,1009,11,82
하정초등학교,,712,1986,712,1986,0,87
학마을한진아파트정문,41293,1971,3083,1969,3083,2,163
학산사거리,37025,6572,290,6554,290,18,221
학산사거리,37027,187,3022,181,3022,6,103
학산사거리,37562,1860,1312,1860,1312,0,102
학산소극장,37169,20486,3964,20476,3964,10,788
학산소극장,37173,8490,17476,8486,17476,4,837
학생안전체험관,39284,2302,4533,2302,4533,0,220
학익.원흥아파트,37015,1763,47,1748,47,15,58
학익2동행정복지센터,37150,13993,7745,13965,7745,28,701
학익2동행정복지센터,37151,8090,13697,8055,13697,35,702
학익고등학교,37029,9950,2851,9916,2851,34,412
학익고등학교,37505,2996,10786,2993,10786,3,444
학익동구치소,37139,327,965,327,965,0,41
학익동성당앞,37630,1348,28,1348,28,0,44
학익동성당앞,37631,85,632,85,632,0,23
학익사거리,37058,31,620,31,620,0,21
학익사거리,37075,3147,1503,3137,1503,10,150
학익사거리,37077,2153,6213,2150,6213,3,269
학익사거리(동아풍림아파트),37084,10750,4918,10724,4918,26,505
학익사거리(동아풍림아파트),37089,9398,8742,9350,8742,48,585
학익시장,37106,14179,5376,14148,5376,31,630
학익시장,37112,2937,10936,2924,10936,13,447
학익시장(법원검찰청),37080,9272,4209,9227,4209,45,434
학익시장앞,37082,3863,5258,3861,5258,2,294
학익여자고등학교,37140,477,1067,477,1067,0,49
학익여자고등학교,37566,539,1072,539,1072,0,51
학익풍림아파트,37487,19,2728,19,2728,0,88
한가라지고개,90157,8,3,8,3,0,0
한가라지고개,90158,0,5,0,5,0,0
한가라지입구,90159,11,3,11,3,0,0
한가라지입구,90160,2,4,2,4,0,0
한가람마을우미린.호수이편한세상,80318,1075,3387,1075,3387,0,143
한강센트럴블루힐.모아엘가2차,80375,250,302,250,302,0,17
한국가스공사,39061,701,998,700,998,1,54
한국가스공사,89273,220,603,220,603,0,26
한국가스공사,89274,96,522,96,522,0,19
한국가스공사인천지역본부,89114,15,41,15,41,0,1
한국가스공사인천지역본부,89115,35,33,35,33,0,2
한국건설생활환경시험연구원,39312,360,315,357,315,3,21
한국건설생활환경시험연구원,39315,678,2997,671,2997,7,118
한국공항공사,25002,84,1196,84,1196,0,41
한국공항공사,25144,20,15,20,15,0,1
한국국토정보공사인천북부지사,42278,5396,6279,5386,6279,10,376
한국국토정보공사인천북부지사,42280,5789,3562,5773,3562,16,301
한국글로벌셰프고등학교,43246,125,94,124,94,1,7
한국글로벌셰프고등학교,43381,39,72,39,72,0,3
한국단자공업연구소,38763,136,364,136,364,0,16
한국단자공업연구소,38764,35,176,35,176,0,6
한국도심공항터미널,35400,7,67,7,67,0,2
한국도심공항터미널,35408,16,189,16,189,0,6
한국도심공항터미널,35417,68,12,68,12,0,2
한국도심공항터미널앞,35645,51,9,35,9,16,1
한국마쓰이,39055,969,1315,969,1315,0,73
한국마쓰이,39057,2722,1656,2722,1656,0,141
한국만화박물관,40583,5406,14304,5376,14304,30,635
한국무역센터.삼성역,23201,1333,4,1333,4,0,43
한국무역센터.삼성역,23251,3177,2897,3177,2897,0,195
한국산업단지공단,39060,701,99,701,99,0,25
한국산업단지공단,39067,37,780,37,780,0,26
한국생산기술연구원,38448,377,619,377,619,0,32
한국생산기술연구원(주조기술센터),42271,403,663,403,663,0,34
한국생산기술연구원(주조기술센터),42719,263,250,263,250,0,16
한국샤프(로얄금속),40600,2368,3577,2366,3577,2,191
한국선교역사기념관,40673,1964,864,1964,864,0,91
한국아파트,37017,3304,9311,3302,9311,2,406
한국아파트,38154,3001,1555,2998,1555,3,146
한국아파트,40714,103,1901,103,1901,0,64
한국아파트,40715,2318,90,2318,90,0,77
한국아파트,40790,15085,15217,15061,15217,24,977
한국아파트,40791,14864,12260,14827,12260,37,874
한국아파트,40792,4225,15425,4183,15425,42,633
한국아파트,40816,10841,9494,10827,9494,14,655
한국아파트,41206,6559,3706,6502,3706,57,331
한국아파트,41208,2370,4221,2326,4221,44,212
한국아파트,80057,2052,43,2052,43,0,67
한국외대송도캠퍼스,38768,0,45,0,45,0,1
한국전력,42947,114,305,114,305,0,13
한국지엠청라주행시험장,89412,1587,1009,1563,1009,24,83
한국지엠청라주행시험장,89413,838,426,837,426,1,40
한국지엠출고문,40560,3719,6385,3712,6385,7,325
한국지엠출고문,40570,5225,3410,5219,3410,6,278
한국콘베어공업,92049,3,0,3,0,0,0
한국타이어인천물류센터,89221,579,1206,577,1206,2,57
한국타이어인천물류센터,89222,590,781,590,781,0,44
한국특수주물(주),42575,469,339,469,339,0,26
한국폴리텍2대학남인천캠퍼스,37448,780,674,780,674,0,46
한국폴리텍2대학남인천캠퍼스,37450,406,438,406,438,0,27
한남시티플라자,40253,21038,13128,21026,13128,12,1102
한들마을입구(유아교육진흥원),42370,9446,6401,9443,6401,3,511
한들마을입구(유아교육진흥원),42371,3601,4713,3591,4713,10,268
한라비발디,35459,8821,3513,8818,3513,3,397
한라비발디,35460,8560,13760,8559,13760,1,720
한라비발디,89180,2522,1247,2522,1247,0,121
한라비발디,89181,1553,3221,1553,3221,0,154
한라비발디정문,89373,54,1275,54,1275,0,42
한라비발디후문.화성파크드림,35658,630,941,625,941,5,50
한라시멘트,35291,139,507,137,507,2,20
한라아파트,39117,1461,3696,1457,3696,4,166
한라아파트,39118,5259,1591,5238,1591,21,220
한림병원,41130,15193,11189,15193,11189,0,851
한림병원,41131,12424,18354,12424,18354,0,992
한미반도체,42754,545,1246,541,1246,4,57
한미반도체,42755,291,217,291,217,0,16
한빛초교앞,39773,1800,7274,1795,7274,5,292
한빛초교앞,39774,6429,2729,6428,2729,1,295
한사랑어린이집,42461,3,76,3,76,0,2
한서유통,40744,278,1124,278,1124,0,45
한성아파트,89020,753,1445,753,1445,0,70
한성자동차학원,42091,831,1691,831,1691,0,81
한수조경,43681,1,15,1,15,0,0
한스엔지니어링,42276,289,286,289,286,0,18
한스엔지니어링,42279,483,451,483,451,0,30
한신더휴스카이파크,35654,1156,1221,1156,1221,0,76
한신더휴스카이파크,35655,1888,888,1888,888,0,89
한신더휴테라스,35761,124,65,124,65,0,6
한신더휴테라스,35762,52,67,52,67,0,3
한신빌리지(A),42249,593,2551,593,2551,0,101
한신빌리지(B),42246,3984,572,3976,572,8,146
한신빌리지(C),42229,2629,632,2615,632,14,105
한신빌리지아파트,42230,517,1333,512,1333,5,59
한신삼부아파트,40806,2079,2816,2079,2816,0,157
한신아파트,37262,4946,3620,4935,3620,11,276
한신아파트,37264,8876,9547,8869,9547,7,594
한신아파트,37267,13115,9861,13102,9861,13,741
한신아파트,41066,2162,1527,2162,1527,0,119
한신아파트,41067,2160,1712,2142,1712,18,124
한신아파트,42095,30,1031,25,1031,5,34
한신휴아파트,40245,5187,71,5187,71,0,169
한신휴아파트,42105,41679,19181,41514,19181,165,1963
한신휴아파트,42106,3053,1886,3049,1886,4,159
한양2차아파트,37512,12849,4331,12849,4331,0,554
한양2차아파트,38055,6245,5005,6223,5005,22,362
한양공구,39664,68,2,67,2,1,2
한양공구,39753,0,77,0,77,0,2
한양공구,42071,443,7470,443,7470,0,255
한양쇼핑,40331,1379,7430,1374,7430,5,284
한양쇼핑,40333,4463,2202,4451,2202,12,215
한양수자인,35450,3242,391,3241,391,1,117
한양수자인,42868,4885,2422,4879,2422,6,235
한양수자인,42893,2926,3470,2919,3470,7,206
한양수자인(후문),35537,4382,952,4381,952,1,172
한양아파트,37076,2147,6834,2136,6834,11,289
한양아파트,37079,5606,651,5593,651,13,201
한양아파트,40269,492,285,492,285,0,25
한양아파트,40310,15132,4649,15110,4649,22,638
한양아파트,40356,14549,9656,14524,9656,25,780
한양아파트,40905,41,424,41,424,0,15
한양아파트2차,38062,3569,5760,3569,5760,0,300
한양화학,42523,3834,1550,3832,1550,2,173
한일금속,89487,3,1286,3,1286,0,41
한일금속,89488,1128,8,1123,8,5,36
한일베라체,42839,4500,1328,4477,1328,23,188
한일베라체,42865,1207,2685,1202,2685,5,125
한일베라체,42948,3924,1713,3920,1713,4,181
한일아파트,41295,1072,2212,1061,2212,11,105
한일아파트,41296,2076,1186,2029,1186,47,105
한일아파트,80195,95,1237,95,1237,0,42
한일튜브(주),42576,460,192,460,192,0,21
한전사택,44090,17,37,17,37,0,1
한전온수출장소,43012,245,507,244,507,1,24
한주글로벌,89306,28,361,28,361,0,12
한진,38540,1,274,1,274,0,8
한진,38541,406,8,406,8,0,13
한진아파트,38016,24978,17059,24963,17059,15,1356
한진아파트,41355,179,474,179,474,0,21
한진아파트후문,41300,2443,462,2441,462,2,93
한풍산업,39014,545,741,545,741,0,41
한화2차,40363,3306,1318,3296,1318,10,149
한화꿈에그린,42860,1205,269,1203,269,2,47
한화꿈에그린,42872,403,1189,394,1189,9,51
한화꿈에그린정문,89372,2875,2356,2875,2356,0,168
한화아파트,40351,12314,7409,12296,7409,18,636
한화아파트,40379,2898,2561,2850,2561,48,176
한화아파트,40380,4899,2361,4861,2361,38,234
한화아파트,41375,3535,2835,3516,2835,19,205
한화지구공원앞,39654,1816,963,1816,963,0,89
한희빌딩,39311,1670,5179,1666,5179,4,220
함박도서관,38286,5455,3235,5455,3235,0,280
함박도서관,38742,514,1940,514,1940,0,79
함박마을,38277,6467,2751,6467,2751,0,297
함박마을문화복지센터,38291,4684,1868,4684,1868,0,211
함박마을문화복지센터,38741,231,2191,231,2191,0,78
함박마을입구,38285,2850,8784,2850,8784,0,375
함허동천,43352,4,43,4,43,0,1
함허동천,43403,64,5,60,5,4,2
합동청사역,35207,22645,5940,22625,5940,20,922
합정역,14220,331,9253,331,9253,0,309
합정역,23029,265,25975,265,25975,0,846
합정역,23030,32489,605,32489,605,0,1067
항동7가버스차고지,35609,1219,28,1009,28,210,40
항동7가버스차고지,35610,240,1017,69,1017,171,40
항동7가버스차고지(삼거리),35704,121,359,9,359,112,15
항동7가버스차고지(삼거리),35705,655,14,578,14,77,21
항운아파트,35065,15686,3761,15578,3761,108,627
항운아파트,35481,979,8090,963,8090,16,292
항운아파트,35602,412,2556,411,2556,1,95
항진축산,39056,672,1849,672,1849,0,81
항진축산,39058,1835,1070,1835,1070,0,93
항청리종점,43558,131,89,118,89,13,7
항포,90247,2,2,2,2,0,0
항포,90248,14,6,14,6,0,0
해광병원,40292,61,2557,61,2557,0,84
해넘이마을,90135,7,10,7,10,0,0
해넘이마을,90136,27,26,26,26,1,1
해돋이공원,38008,44,242,42,242,2,9
해돋이공원,38010,413,752,413,752,0,37
해돋이공원,38718,59,60,59,60,0,3
해돋이도서관,38729,189,44,189,44,0,7
해돋이도서관,38730,8,581,7,581,1,19
해뜨는집앞,35531,1,31,1,31,0,1
해뜨는집앞,35726,48,2,47,2,1,1
해망,90352,2,5,2,5,0,0
해망,90353,13,1,13,1,0,0
해맞이공원앞,35616,314,820,314,820,0,36
해맞이공원앞,35617,652,311,652,311,0,31
해명초등학교앞,90179,13,4,12,4,1,0
해명초등학교앞,90180,11,43,11,43,0,1
해모로월드뷰,39794,1489,416,1489,416,0,61
해모로월드뷰,39805,499,1153,499,1153,0,53
해물탕거리,40782,3849,2280,3849,2280,0,197
해병2사단.향동,80054,710,763,709,763,1,47
해사고등학교,35503,1267,16,1267,16,0,41
해사고등학교.한국이민사박물관,35126,84,2016,84,2016,0,67
해서초등학교,41166,560,718,558,718,2,41
해서초등학교,41168,595,1370,592,1370,3,63
해성단조,42813,40,0,40,0,0,1
해송노인요양병원,35552,3,66,3,66,0,2
해송노인요양병원,35553,17,4,17,4,0,0
해수워터피아,42082,2876,874,2876,874,0,120
해수워터피아,42083,1411,7315,1411,7315,0,281
해안도로신항만교,39001,272,916,272,916,0,38
해안도로신항만교,39002,761,685,761,685,0,46
해암약수,90161,24,6,24,6,0,0
해암약수,90162,2,13,2,13,0,0
해양경찰청,38014,1936,3439,1921,3439,15,173
해양경찰청,38015,5914,3482,5900,3482,14,303
해양경찰청,38411,9485,7362,9485,7362,0,543
해양기계,39532,37,81,37,81,0,3
해양기계,39696,2,183,2,183,0,5
해오름민박,43413,88,21,84,21,4,3
해오름민박,43442,11,52,11,52,0,2
해원고등학교,42964,10,665,9,665,1,21
해원중학교,42972,1595,133,1590,133,5,55
해원중학교,42973,93,893,93,893,0,31
해원중학교후문,42965,1443,426,1429,426,14,60
해피타운앞,44139,37,10,37,10,0,1
해피타운앞,44198,15,35,13,35,2,1
핸즈코퍼레이션,89262,10,2396,10,2396,0,77
핸즈코퍼레이션,89263,6,39,6,39,0,1
햇내로공원입구,35777,13,0,13,0,0,0
햇내로공원입구,35784,0,24,0,24,0,0
행복마을입구,35687,59,20,59,20,0,2
행복마을입구,35690,15,60,14,60,1,2
행자골,43350,2,16,1,16,1,0
행자골,43583,24,5,24,5,0,0
행정복지센터사거리,40332,1261,2977,1261,2977,0,136
향나무골,43131,18,12,18,12,0,0
향나무골,43648,34,22,33,22,1,1
향동해병2사단,80055,1042,1493,1041,1493,1,81
향촌휴먼시아2단지,39741,8475,15284,8475,15284,0,766
허브주유소,35446,333,425,333,425,0,24
허브주유소,35447,416,6473,415,6473,1,222
허튼개,90119,1,7,1,7,0,0
허튼개,90120,15,2,15,2,0,0
헤나무,43199,1,50,1,50,0,1
헤나무,43317,38,4,38,4,0,1
혁이네슈퍼,40738,34,637,34,637,0,21
혁이네슈퍼,40739,283,36,283,36,0,10
현광아파트,37007,2263,18,2259,18,4,73
현광아파트,37488,7,2307,7,2307,0,74
현광아파트,39380,17398,17634,17353,17634,45,1130
현광아파트,41071,5766,1610,5766,1610,0,237
현광아파트,41432,2967,6336,2967,6336,0,300
현광아파트,42258,102,340,102,340,0,14
현광아파트,42260,684,229,679,229,5,29
현광아파트(호산부인과),39376,31431,16937,31365,16937,66,1560
현광아파트후문,37560,2622,14,2616,14,6,85
현광아파트후문앞,37559,49,1504,6,1504,43,50
현대.태화아파트,41402,532,3702,530,3702,2,136
현대102동,40146,2509,937,2507,937,2,111
현대121동,40137,6011,799,6011,799,0,219
현대1단지관리사무소,40740,228,2419,228,2419,0,85
현대1차아파트,38061,6506,3690,6501,3690,5,328
현대1차아파트,41365,10153,810,10144,810,9,353
현대1차아파트정문,41367,144,329,135,329,9,15
현대207동,40168,541,9303,540,9303,1,317
현대209동,40167,9955,552,9953,552,2,338
현대2차아파트,38173,2123,2904,2111,2904,12,162
현대2차아파트,41106,758,4229,758,4229,0,160
현대2차아파트,41112,8566,718,8553,718,13,299
현대2차아파트,41366,614,6028,612,6028,2,214
현대2차아파트정문,41364,498,6249,490,6249,8,217
현대310동(서중학교),40097,463,2196,463,2196,0,85
현대3단지,40127,9398,6426,9365,6426,33,510
현대3단지,40129,8405,11324,8384,11324,21,636
현대3차아파트,38168,18060,11130,17926,11130,134,941
현대3차아파트,38342,17054,15363,17023,15363,31,1045
현대4차아파트,38158,1854,2390,1848,2390,6,136
현대4차아파트,38183,2380,3010,2371,3010,9,173
현대4차아파트,38186,3713,1502,3693,1502,20,168
현대5차,40405,10343,6802,10313,6802,30,553
현대5차,40408,6568,3967,6495,3967,73,339
현대5차아파트,38176,4064,1658,4050,1658,14,184
현대동부시장,36041,11705,5827,11613,5827,92,565
현대모닝.임광그대가아파트,39579,7525,3257,7515,3257,10,347
현대백화점,22003,3815,54,3815,54,0,124
현대슈퍼,43376,353,20,348,20,5,12
현대슈퍼,43617,5,131,5,131,0,4
현대시장,36042,9551,6204,9496,6204,55,508
현대시장,36043,7151,9286,7107,9286,44,530
현대시장,36118,7044,8930,7008,8930,36,515
현대써비스,42021,3714,2988,3713,2988,1,216
현대아파트,35396,331,20,331,20,0,11
현대아파트,37154,2892,7464,2892,7464,0,334
현대아파트,37161,6724,3620,6724,3620,0,333
현대아파트,39267,5815,5560,5796,5560,19,366
현대아파트,39271,6231,3300,6201,3300,30,307
현대아파트,40112,35636,27355,35581,27355,55,2031
현대아파트,40681,1787,7593,1784,7593,3,302
현대아파트,40682,8146,1488,8144,1488,2,310
현대아파트,40737,783,2205,783,2205,0,96
현대아파트,40788,37270,33977,37226,33977,44,2298
현대아파트,43082,66,504,66,504,0,18
현대아파트,43083,467,117,467,117,0,18
현대아파트.통진도서관,80135,193,954,186,954,7,37
현대아파트.통진도서관,80136,1339,161,1335,161,4,48
현대아파트105동,40734,70,904,70,904,0,31
현대아파트105동,40735,616,257,616,257,0,28
현대아파트113동,40105,10029,6224,10000,6224,29,524
현대아파트116동,40732,1741,390,1741,390,0,68
현대아파트119동,40733,61,2497,61,2497,0,82
현대아파트120동앞,40140,394,5027,394,5027,0,174
현대오일뱅크,41459,2301,1435,2281,1435,20,120
현대자동차빌딩앞,40103,5798,13254,5779,13254,19,614
현대자동차서비스,42032,10023,2983,10004,2983,19,419
현대자동차서비스,42033,14150,9626,14090,9626,60,766
현대제철,36086,492,1204,492,1204,0,54
현대제철,36123,2854,706,2845,706,9,114
현대제철정문,36133,530,1319,526,1319,4,59
현대철강레이져,90220,1,40,0,40,1,1
현대철강레이져,90221,9,1,9,1,0,0
현송중학교,38744,3683,1195,3683,1195,0,157
현송중학교,38745,2133,2555,2133,2555,0,151
형제마트,40004,501,1899,482,1899,19,77
형제마트,40006,1608,645,1596,645,12,72
혜덕,90217,1,1,1,1,0,0
혜성프라자,40393,23848,13867,23789,13867,59,1216
혜성프라자,40395,16299,18381,16251,18381,48,1118
호구포역,39784,6287,7910,6284,7910,3,457
호구포역,39785,10707,8644,10701,8644,6,624
호구포역2번출구,92040,1391,457,1391,457,0,59
호명사입구,40093,3,597,3,597,0,19
호박골,43437,26,27,25,27,1,1
호박골,43784,77,13,74,13,3,2
호박골사거리,43123,7,44,6,44,1,1
호박골사거리,43124,62,8,61,8,1,2
호박골사거리,43706,3,277,3,277,0,9
호박골사거리,43804,114,16,113,16,1,4
호반베르디움,42855,564,4997,564,4997,0,179
호반베르디움14단지,42880,1338,3822,1328,3822,10,166
호반베르디움214동앞,42998,260,741,260,741,0,32
호반베르디움2차,89112,1659,1262,1659,1262,0,94
호반베르디움2차,89113,1243,1236,1243,1236,0,79
호반베르디움3차아파트,42743,2824,7017,2822,7017,2,317
호반베르디움3차아파트,42908,1371,4489,1362,4489,9,189
호반베르디움아파트,39922,2506,794,2506,794,0,106
호반베르디움아파트107동,92011,4075,252,4074,252,1,139
호반써밋1차 3101동,89393,655,2604,655,2604,0,105
호반써밋1차 3101동,89394,1384,218,1384,218,0,51
호반써밋1차아파트,89472,982,461,982,461,0,46
호반써밋1차아파트,89473,1773,2356,1773,2356,0,133
호반써밋송도,38637,5255,219,5244,219,11,176
호반써밋송도(109동),38634,1042,1907,1042,1907,0,95
호반써밋스카이센트럴1차아파트,35892,237,718,236,718,1,30
호반써밋스카이센트럴1차아파트,35893,453,266,450,266,3,23
호불사입구,38180,2563,2931,2560,2931,3,177
호불사입구,38182,2693,2193,2687,2193,6,157
호세요양원,43221,30,144,30,144,0,5
호세요양원,43311,5,12,5,12,0,0
호수공원,89103,81,547,81,547,0,20
호수공원,89104,2617,609,2617,609,0,104
호수공원음악분수,89027,2034,1173,2020,1173,14,103
호수공원음악분수,89028,1004,2365,1003,2365,1,108
호수마을5단지후문,35270,51,38,51,38,0,2
호수마을5단지후문,35735,68,79,68,79,0,4
호수마을이편한세상.한가람우미린,80319,1076,528,1074,528,2,51
홈씨씨인천점,42955,60,378,59,378,1,14
홈씨씨인천점,42957,109,29,109,29,0,4
홈씨씨인천점,89188,404,697,404,697,0,35
홈플러스,80070,291,2720,291,2720,0,97
홈플러스,89225,658,397,658,397,0,34
홈플러스,35218,476,1588,476,1588,0,66
홈플러스.산림조합,80018,3035,188,3035,188,0,103
홈플러스계산점,41622,26,1757,26,1757,0,57
홍대입구역,23011,369,6257,369,6257,0,213
홍대입구역,23031,43527,773,43527,773,0,1429
홍대입구역,23032,576,19111,576,19111,0,635
홍예문·공영주차장,35794,15,354,15,354,0,11
홍예문·공영주차장,35806,46,404,46,404,0,14
홍의사거리,43798,32,52,32,52,0,2
홍의사거리,43813,3,18,3,18,0,0
홍의삼거리,43441,9,32,9,32,0,1
홍의삼거리,43613,45,22,43,22,2,2
홍익자원,35514,1445,581,1442,581,3,65
홍익자원,35515,81,976,79,976,2,34
홍현마을,90002,20,5,18,5,2,0
홍현마을,90003,6,36,6,36,0,1
화개사입구,90034,0,80,0,80,0,2
화개사입구,90035,78,0,78,0,0,2
화개정원,90405,5,47,5,47,0,1
화곡역,16147,45804,50167,45804,50167,0,3095
화도,43077,115,120,111,120,4,7
화도고개,36027,1856,2338,1839,2338,17,135
화도고개,36028,1592,4322,1579,4322,13,190
화도돈대,43676,29,5,29,5,0,1
화도돈대,43863,0,29,0,29,0,0
화도진공원.화도진도서관,36033,11359,3194,11324,3194,35,469
화도진공원.화도진도서관,36035,3549,11107,3529,11107,20,472
화도진중학교,36064,3222,915,3158,915,64,133
화도진중학교,36066,1027,3127,1005,3127,22,134
화도터미널,43104,943,1258,909,1258,34,71
화도터미널,43105,1331,712,1315,712,16,65
화력발전소,42628,228,257,228,257,0,15
화문석문화관,43452,0,1,0,1,0,0
화물터미널,35039,8,447,8,447,0,14
화물터미널,35040,248,26,248,26,0,8
화성보일러,39107,2857,5778,2857,5778,0,278
화성파크드림.스카이시티자이,35651,7510,2106,7500,2106,10,310
화성파크드림후문.한라비발디,35659,546,1066,546,1066,0,52
화수부두,36147,625,1496,601,1496,24,68
화수사거리,36072,2435,779,2406,779,29,103
화수사거리,36104,377,1392,372,1392,5,57
화전초교사거리,41087,851,1195,851,1195,0,66
화전초등학교,41085,1028,489,1028,489,0,48
화전초등학교,41086,629,662,629,662,0,41
화평철교.화평동냉면거리,36014,3327,3428,3310,3428,17,217
화평철교.화평동냉면거리,36016,15788,22110,15697,22110,91,1222
화훼단지,89489,2,9,2,9,0,0
화훼단지·당미교,41462,70,276,70,276,0,11
화훼단지·당미교,41463,82,153,82,153,0,7
환경공단강화사업소,90109,1,2,1,2,0,0
환경공단강화사업소,90110,1,0,1,0,0,0
황곡노인정,89310,39,3,30,3,9,1
황곡노인정,89320,126,114,102,114,24,7
황곡상회,89311,27,6,26,6,1,1
황곡상회,89330,0,40,0,40,0,1
황골,43992,10,42,9,42,1,1
황골,43993,66,5,58,5,8,2
황골마을,43135,9,5,9,5,0,0
황골마을,43277,13,1,13,1,0,0
황련사입구,43328,65,92,63,92,2,5
황련사입구,43630,47,0,32,0,15,1
황산도,43635,5,53,5,53,0,1
황산도관광밸트,43873,0,1,0,1,0,0
황산도관광밸트,43876,1,7,1,7,0,0
황산도입구,43636,45,7,45,7,0,1
황산도입구,43861,11,25,11,25,0,1
황청리종점,90207,1,0,0,0,1,0
효성2동치안센터,41024,2055,9174,2043,9174,12,362
효성고등학교,41074,1609,596,1586,596,23,71
효성고등학교,41075,702,2374,694,2374,8,99
효성남초등학교,41040,6151,2839,6146,2839,5,290
효성노인문화센터,41409,551,1716,551,1716,0,73
효성노인문화센터,41410,547,710,547,710,0,40
효성농협,41039,2652,1427,2621,1427,31,131
효성뉴서울아파트,41060,11894,1854,11858,1854,36,443
효성뉴서울아파트,41061,2305,13283,2275,13283,30,502
효성뉴서울아파트202동,41078,1626,16337,1610,16337,16,579
효성뉴서울아파트204동,41368,14119,1761,14089,1761,30,512
효성대신아파트,41041,5766,2897,5676,2897,90,279
효성대신아파트,41042,501,3938,494,3938,7,143
효성도서관,41420,2450,377,2441,377,9,91
효성동동화운수차고지,41573,9585,3947,9511,3947,74,436
효성명현초등학교,41065,3724,990,3638,990,86,152
효성사거리,41017,1221,5495,1220,5495,1,216
효성사거리,41018,11431,4393,11373,4393,58,510
효성사거리,41019,5088,5649,5058,5649,30,346
효성사거리,41631,762,793,760,793,2,50
효성상아아파트,39357,14313,16936,14256,16936,57,1008
효성상아아파트,39358,18546,13313,18485,13313,61,1027
효성서초등학교,41557,2979,521,2979,521,0,112
효성서초등학교,41558,505,2745,505,2745,0,104
효성서초등학교,41579,191,938,191,938,0,36
효성서초등학교,41580,1523,585,1523,585,0,68
효성성모병원,41022,4679,236,4679,236,0,158
효성소방파출소,41023,8483,2895,8455,2895,28,367
효성신사거리,41030,1557,8162,1540,8162,17,313
효성신사거리,41031,7345,1545,7310,1545,35,286
효성아파트,42166,9516,2398,9516,2398,0,384
효성아파트,42168,2592,8364,2592,8364,0,353
효성중앙교회,41021,161,7348,161,7348,0,242
효성프라자,41052,11746,10148,11659,10148,87,706
효성프라자,41055,6096,5781,6018,5781,78,383
효성현대3차,41049,1384,3188,1342,3188,42,147
효성현대3차아파트,41051,897,507,889,507,8,45
효성현대4차,41035,2203,4332,2122,4332,81,210
효성현대4차아파트,41036,4332,1698,4301,1698,31,194
효자교앞,90199,5,0,5,0,0,0
효자교앞,90200,1,10,1,10,0,0
효정아파트,38260,1409,1839,1409,1839,0,104
후정초등학교.삼산도서관,40685,119,1315,119,1315,0,46
후지테크,39051,2221,1453,2220,1453,1,118
후지테크,39052,564,2134,563,2134,1,87
후포항입구,43431,9,147,8,147,1,5
후포항입구,43481,74,31,61,31,13,3
휴먼시아1단지,40837,3202,6695,3197,6695,5,319
휴먼시아1단지,40838,6144,1792,6137,1792,7,256
휴먼시아1단지,40840,1054,3,1054,3,0,34
휴먼시아1단지,40852,100,1903,100,1903,0,64
휴먼시아후문,42885,9548,3935,9538,3935,10,434
흥성리,18804,3,230,3,230,0,7
흥성리,62029,223,13,215,13,8,7
흥왕2리마을회관 앞,43122,32,21,30,21,2,1
흥왕2리마을회관 앞,43520,38,22,36,22,2,1
흥왕리,90073,0,10,0,10,0,0
흥왕리,90074,5,7,4,7,1,0
흥왕상회,43502,34,10,34,10,0,1
흥왕상회,43516,9,1,9,1,0,0
희경산업·남동스카이장례식장,39031,221,136,221,136,0,11
희경산업·남동스카이장례식장,39961,62,200,62,200,0,8
희망찬요양병원,38126,4357,7152,4350,7152,7,371
희망천입구,40091,5738,4549,5693,4549,45,331
희망천입구,40799,5606,5338,5579,5338,27,353
희망체육공원입구,40912,5476,54,5469,54,7,178
희성금속,42018,104,545,99,545,5,20
힐데스하임,42876,8947,2379,8940,2379,7,365
힐스테이트,35457,15866,10086,15845,10086,21,837
힐스테이트,35458,6613,4840,6610,4840,3,369
힐스테이트레이크송도(후문),38630,2174,1568,2174,1568,0,120
힐스테이트레이크송도(후문),38656,1748,1219,1748,1219,0,95
힐스테이트레이크송도1차입구,38655,1025,909,1025,909,0,62
힐스테이트레이크송도1차입구,38751,440,829,440,829,0,40
힐스테이트레이크송도2차(201동),38641,1869,2070,1869,2070,0,127
힐스테이트레이크송도2차(201동),38657,1694,1037,1694,1037,0,88
힐스테이트송도더테라스(정문),38715,1475,430,1475,430,0,61
힐스테이트송도더테라스(정문),38716,273,977,273,977,0,40
힐스테이트송도더테라스(후문),38713,2710,2611,2710,2611,0,171
힐스테이트송도더테라스(후문),38714,1089,2058,1089,2058,0,101
힐스테이트푸르지오주안,37293,35762,39102,35606,39102,156,2414
힐스테이트푸르지오주안,37300,12260,15696,12221,15696,39,901
힐스테이트푸르지오주안아파트,37680,9630,11004,9613,11004,17,665
힐스테이트학익,37022,5991,5062,5977,5062,14,356
힐스테이트학익,37023,4685,7846,4679,7846,6,404
힐스테이트학익104동앞,37669,1419,1846,1412,1846,7,105
힐스테이트학익104동앞,37670,2471,4864,2469,4864,2,236
힐캐슬프라자,39329,11212,16701,11168,16701,44,900
힐캐슬프라자,39331,18099,9288,18040,9288,59,883
힘찬병원,40891,5455,7497,5425,7497,30,417
힘찬병원,40892,4020,2770,3999,2770,21,219
